[NEW_DOCUMENT: DOCid=0, lang=nah, DOCNAME=CENTE COUATL HUAN TLACATL ].	[NEW_DOCUMENT: DOCid=0, lang=spa, DOCNAME= LA CULEBRA Y EL HOMBRE ].
CENTE COUATL HUAN TLACATL .	LA CULEBRA Y EL HOMBRE .
Cecpa, cente couatl, opanotaya itzallan orne huey quame totomaque. ~~~ In iquac inin opanotaya omallauh quahuitl, ipan ohuetzico; imán otillin yocueloquiz, imán open mocuellohua, mocuellohua.	Si no estás de acuerdo, trae cuatro personas y delante de ti les preguntaré y verás cómo es cierto que un bien con un mal se pagaFuese luego el buen hombre en busca de cuatro animales machos.
Zan nenca ocachi ipan opachitaya, ye iyomiquía, ihuan cente tlacatl ochantía amo hueca canin oyeya quauhtlatli, oquilnamic oquaquahuizquía, tlen oquichin: ocan intepoznecochtli oya oquaquahuito.	No tuvo que andar muy lejos, cerca de ahí los encontró. ~~~ Llevó un buey, un caballo, un león y un coyote.
Inin oacito quauhtla opanotaya ica nica oyeya couatl oquicac tlazanatza omocuep ontlachix couatl ompon oyeya couatl oquitzatzilli quilhuía: —Qualli tlacatl xihualla xinechiquanilliqui inin quahuitl, nechmictitica. —Amo timitziquanilliz tlamo tinechquaz.	La culebra comenzó a preguntar a cada uno de los animales, delante del buen hombre. —Buen león, ¿no es cierto que un bien con un mal se paga? —Sí. —Buen buey, ¿no es cierto que un bien con un mal se paga? —Sí. —Buen caballo, ¿no es cierto que un bien con un mal se paga? —Sí.
Couatl onahuatl quilhuía: —Amo timitzquaz, xinechiquanilliqui, yotimitzilhui amo timitziquanilliz, amitla timitzchihuilliz; tle amo timoyolcocoa?	Cuando el buen hombre oyó lo que decían aquellos animales, que siempre un bien con un mal se paga, se asustó.
Xihualla xinechiquanilliqui, timitztlatlatía!	Sólo faltaba preguntar al coyote si era o no cierto lo que decía la culebra.
Zazan oquitlatlati couatl, imán tlacatl omopacho, open quitequi ica tepoznecochtli in quahuitl; oncan oquíquanilli, oquiz couatl; open motenpapalohua; yoquinequía tlaquaz; oquipiaya ce tonalli amo otlaquaya.	Llegóse la culebra al coyote: —Buen coyote, ¿no es cierto que un bien con un mal se paga? —Falta que vea yo cómo estabas y así podré decir si es o no cierto lo que dices, y si está bien que te comas a este buen hombre, o no. Ponte como estabas antes.
Ima quitohua: —Qualli tlacatl, ye napizmiqui, axan nia timitzquaz, nicpía ce tonalli amo nitlaquatica.	Los otros animales contestaron juntos: —¡Que se ponga; veremos!
Tlen tiquitohua, qualli tlacatl? —Quénin! ~~~ Tia tinechquaz!	Entonces, la culebra se colocó otra vez entre los árboles, y luego le dijo el coyote: —Ahora, ¡quédate!
Quénin zazan iquión?	Nosotros ya nos vamos.
Inon yo timitziquanilli quahuitl ica otimiquizquía ihuan axcan ticnequi tinechquaz! —Tle tehua qualli tlacatl, amo ticmati que ce qualli ica ce amoqualli moxtlahua? —Amo.	La dejaron retorciéndose y chillando, como cuando la encontró el buen hombre.
Occepa onahuat couatl: —Tle amo timoneltoca? —Amo, amo noneltoca tlen tiquitohua. —Tía amo timoneltoca, xiqumhuallica nahui tlaca ihuan mixtla niquintlatlaniz, ihuan tiquitaz que mellahuac, que ce qualli ica ce amoqualli moxtlahua.	El buen hombre le dio las gracias al buen coyotito. —Ahora, buen coyotito, vamos juntos a mi casa. —¿A hacer qué? —Quiero regalarte algunos pollos. —No déjalo; yo me voy por aquí. —¡No, vamos! —Mira, ahora ya es tarde; es mejor, si quieres regalármelos, que mañana temprano me los lleves sobre ese montículo; te esperaré muy de mañana; cuando aún no sale el sol.
Niman oya qualli tlacatl, oquitemoto nahui oquichyolcame.	Al dar las cinco ya estarás ahí.
Amo 2hueca onene, zan ica nepa oquinnextito, oquinhuallicac cente quacue, cente cauayo, cente hueymiztli ihuan cente coyotl.	Así quedamos.—No, no vendrás y me harás regresar en balde. —No, aquí te esperaré, buen hombre. ~~~ En esto convinieron el coyote y el hombre.
Couatl open quintlatlanía occequin yolcame ixtlan qualli tlacatl cecentiacan: —Qualli hueymiztli, amo mellac que ce qualli ica ce amoqualli moxtlahua? —Quema. —Qualli quacue, amo mellac que ce qualli ica ce amoqualli moxtlahua? —Quema. —Qualli cahuayo, amo mellac que ce qualli ica ce amoqualli moxtlahua? —Quema.	
Imán nin qualli tlacatl oquicac nochi tlen inin yolcame oconitoque, que nochi qualli ica ce amoqualli moxtlahua, omocamic.	El buen coyote tomó por el llano y se fue; el buen hombre también cogió su camino. ~~~ Cuando llegó a su casa no más veía atontado.
Za coyotl opollihuía quitlatlaniz tía mellac onoce amo mellac tlen oquitohuaya couatl.	Le dice su mujer: —¿Qué te pasa? ~~~ Nada más estás mirando atontado.
Oacito couatl itech coyotl: —Qualli coyotl, amo mellac que ce qualli ica ce amoqualli moxtlahua? —Pollihui niquitaz que otieya huan icón qualli timitzilhuiz tía mellac onoce amo mellac tlen tiquitohua, tía qualli tiquaz nin qualli tlacatl onoce amo.	Entonces comenzó a contarle lo que le había pasado: —Me encontré con una culebra que quería comerme.
Tlaximotlalli que ochtopa otieya.	Al oírlo se asustó la mujer: —Ya te decía que no salieses.
Occequin yolcame onahuatque tlamach: —Man motlalli, tía tiquittacan!	No me oíste, si no, no te hubieses espantado; ya viste que por la voluntad de Dios no te pasó nada; porque Dios te mandó a ese animalito para que te ayudase.
Niman omotlalitihuetz occepa itzallan quame, oncan quilhuía coyotl: —Axan ompa ximocahua, tehuan ye tiaui.	De otro modo, yo no hubiera sabido lo que te había pasado; no habrías regresado a casa. —Ahora iba a traer al buen coyotito. —¡Dios no lo quiera!
Oquicateque, mocuellotica ihuan pitzatzi, que imán oquinextito qualli tlacatl.	Acabaría con mis pollos. —No accedió a lo que le decía que escogiese él mismo los que quisiese entre los pollos mejores y más gordos.
Qualli tlacatl oquitlazocamachilli qualli coyotl. —Axan, qualli coyotl, cepan tiacan nochan. —Tlen taitihue? —Axan nicnequi timitzintlacolliz cequi pióme. —Amo, xiccahua; nehuatl ica nican nia. —Amo, tiahue! —Axan tlaxquita, ye tiotlac; ocachi qualli tía ticnequi tinechintlacolliz, moztla, zan ocuatzinco, xinechinhualiquilli ipan inin tlatlatelli, timitzchía, zan ocuatzinco, iquac ayemo quixohuatzin tonnalli; imán tzilliniz macuilli tepozcalapillolli ye oncan tíez iquión tocahua.—Amo ye, amo tihuallaz huan zan nenca nocuepaquin. —Amo, in ica, nican timitzchía, qualli tlacatl.	
Omocacaque que coyotl que tlacatl.	Mañana, muy temprano, quedé con ese animalito en llevarle algunos pollos.
Qualli coyotl oquiquitzque ixtlahuac, huan oya qualli tlacatl no oquiquitzqui iohui.	Escoge unos pollos buenos pues mañana, ya te dije, se los llevaré. —Mañana no irás a ningún lado.
Oecoc ichan zan mocamauhcatlachía.	No quiero que le lleves nada a ese maldito animal: ni un solo pollo.
Quilhuía izouan: —Tlenon mopan mochihua?	Ya se me ocurrió qué es lo que debes hacer. —¿Qué?
Zan timocatlachía!	Dímelo. —No seas tonto, ¿qué ha de ser?
Imán ye open quinonotza, tlen ipan omochihuazquia: —Onicnextito cente couatl oquinequía nechquaz.	
Niman omocamic zouatl. —Yotimitzilhuiaya amo otiani; amo otinechcac, tlamo amo otimomotiani otiquittac que ica Dios ihuelitzin amitla mopan omochin, icanica Dios omitztitlanilli inon yoyolcatl omitzpaUehuito, tlamo axan nehuatl amo nicmatizquía tlenon mopan omochihuani amo otiuallacallaquini. —Axan oniquallicazquía qualli coyotl. —Mancamo Dios!	Deja los pollos y llévale esos perros que son de los más mordelones; pónlos dentro del saco de pita y en cuanto llegues a donde te espera, sin acercarte a él demasiado, desde lejos, se los sueltas. —Lo que has discurrido, mujer, no está bien. ~~~ ¿Cómo quieres que le lleve lo que no debo llevarle?
Oncan quintlamiz nopiouan! —Amo oquinec oniquilhuiaya, oncan oquin tlapepeniani tlen yehua oquinequini inon pióme ocachi quaqualli, totomaque.	Lo engañaría. ~~~ ¿Por qué no eres buena, mujer? ~~~ Voy a llevarle los pollos. —Ya te dije que no, y si se los llevas, me enfadaré contigo, y armaré la gorda.
Axan moztla zan ocuatzinco yotocaque ica nin yoyolcatl, niquinhuiquilliz cequi pióme; xinech in tlapepenilli non quaqualli pióme; moztla, yotimitzilhui, niquinhuicaz. —Moztla amo cana tiatica.	El hombre no quiso disgustar a su mujer e hizo lo que ordenaba. ~~~ Al día siguiente, metió los perros en el costal de pita y salió muy temprano.
Amo nicnequi ida ticuiquilliniz inon xolopi yolcatl!	Se cargó los perros en lugar de los pollos que había ofrecido el día anterior.
Nian cente pioton!	El hombre deseaba que no estuvieseahí el coyote.
Yo nicnemilli occachi qualli tlen ticchihuaz. —Tlenon?	Ya iba llegando el hombre, y estiraba el pescuezo para ver si ya estaba ahí el coyote.
Tía xinechilhui! —Amo xi ixquahuitl!	Lo descubrió desde muy lejos.
Tlen ticchihuaz xiquincahua pióme, xiquinhuiquilli non chichime occachi tlaquaquani, xiquintlalli itic ichpoxatli ihuan zan que taciz canin mitzchía, amo zazan ximopacho itlac zan hueca xiquincacahuilli. —Tlen oticnemilli amo qualli ca!	
Quénin ticnequi nicichhuicaz tlen amo nicuiquilizquia?	El coyote, muy contento, iba y venía, esperando sus pollos.
Zan nicquamanaz! ~~~ Tleca amo qualli tizohuatl?	Llegó arriba del montículo donde ya lo esperaba el coyotito.
Nia niquinhuicaz pióme. —Yotimitzilhui que amo, huan tía tiquinhuicaz niquallaniz ihuan nichueicachihuaz.	Este comenzó a reír muy contento. —Bueno coyotito —le dijo el hombre—, ya que vine a traerte los pollos.
Tlacatl amo oquinec quiquallaniz izouan, oquichin tlen oquitequimacac.	Ahora dime: ¿cómo quieres que los suelte?
Moztlatica tlen oquichin oquinaqui itic ichpoxatli, zan ocuatzinco oquiz.	¿Uno a uno, o todos juntos? —Que no sea uno a uno; es mejor que sea juntos, para que yo me divierta cazándolos.
Oquinmamaten chichime oquinmacato nelli pióme que yeyalhua omocaque; tlacatl oquinequía amonpon oyenicoyotl; yoacitaya tlacatl on moquequechtilana tía ye ompon oyeya onoce amo coyotl, oquixtlallo zan hueca.	El hombre empezó a soltar la boca del costal; mientras, el coyotito se había sentado a esperar que saliesen los pollos, imaginándose ya que los cazaba, sentía que los cogía.
Coyotl zan papaqui papaxialohua, quinchía ipiohuan, oecoc ipan tlatlatlelli canin ye oquichíaya cocoyotl, open huehuetzca coyotl, papaqui. —Qualli cocoyotl yonihualla, timitzincahuillico pióme, Axan, quénin ticnequi timitzincahuilliz, cecentiacan onoce tlamach? —Cecentiacan amo, ocachi qualli tlamach xinechcahua, man nitlamahuizo.	
Open quicamactotoma ichpoxatli.	¡Y he aquí que le fue soltando los perros!
Coyotl yomotlalli za quinchía quizazque pióme, on momamatti ye oquinquitzqui.	¡De esos que arrastran las orejas! ~~~ Y apenas los vio el coyote, ya estaban sobre él.
Oquincacan chichime, non nacazhuihuilaxtique.	Primero se asustó, y a la vez que se asustó, se revolvió furioso a reñir con los perros.
Coyotl zan que oquimitac ipan oyetaque, omocamic, iquion que omocamic noiqui omotlahuelcuitiquiz ica chichime motehuía, motehuía, chichime oquitlanitzpozteque coyotl, coyotl oquinquetzo nohuian, oquinmapopoztec oquinnacazcocoton, que ce que occe omocoltique.	Los perros le quebrantaron los huesos de las patas, mientras él los mordía por dondequiera, rompiéndoles las manos y desgarrándoles las orejas. ~~~ Mutuamente se lastimaron.
Coyotl zan que oquittac que oquixilique, ochollo ica itic quayo, amocehuitaya, otlachiaya ica nica oquincan amoqualli tlacatl ica ichichihuan; omataya canin oquicocoltique ihuan otlacolcho! ca ya coyotl oquitohuaya: —Ua, ua, ua, ua, ua, ua, Qualli oquitohuaya couatl que ce qualli ica ce amoqualli moxtlahua!	En cuanto el coyote comprendió que iban a ganarle, huyó bosque adentro. ~~~ Se reposaba a trechos, volviéndose a ver hacia donde había dejado al hombre con sus perros, y contemplando las heridas que le habían causado, exclamó llorando: —Gua, gua, gua, gua, ¡Con razón decía la culebra que un bien con un mal se paga!
[END OF DOCUMENT].	[END OF DOCUMENT].
[NEW_DOCUMENT: DOCid=1, lang=nah, DOCNAME=CACAPIZCAYOTL HUAN TECUANI ].	[NEW_DOCUMENT: DOCid=1, lang=spa, DOCNAME= EL ZORRITO Y EL LOBO ].
CACAPIZCAYOTL HUAN TECUANI .	EL ZORRITO Y EL LOBO .
Cente capizcayotl ica iconen ochantía itic cente huey tlacoyotl, canin oquipiaya inchan.	Una zorra vivía con su hijo dentro de un gran hoyo, en donde tenían su casa.
Cecpa nantli quilhuia iteconen: —In icuac cana tipaxiolotin, amo zan ica tia; nia timitzilhuiz aquinon timotlatlachilliz. —Que aquinon notlatlachilliz? —Nia timitzilhuiz: ximixoti none nin yolcatl itoca tecuani.	Una vez la mamá le dijo a su hijo: —Cuando a alguna parte vayas a pasear, no así nomás vayas; te voy a advertir de quién debes cuidarte. —¿Cómo de quién debo cuidarme? —Te lo voy a decir: cuídate de ese animal que se llama lobo.
Imán oquiz iconen nin capizcayotl, occepa oquilhui que achtopa, man mixoti imán quizaz ame quitaz tecuani. —Ye otimitzilhui ximoixoti in icuac tiquizaz. —Huan tlenon inon tecuani? —Ah noconen!, Inon tecuani campa mitzitaz, yeca ye omitzcua. —Tle nechcuaz?	Cuando salió el hijo de esta zorra, volvió a decirle, como la vez primera, que cuidase de que no fuese a verlo el lobo. —Ya te dije que te cuides cuando lo veas. —¿Y qué es eso de lobo? —¡Ah, hijo mío!, ¡El lobo, en donde te vea, ya está que te comió! —¿Qué me comerá? ~~~ ¿Y que me hará? —¿Qué te hará?
Yatlen nechchihuaz? —Oque tlen mitzchihuaz?	Te matará y ya nunca volveremos a vernos.
Mitzmictiz huan yoquic totazque; timitzilhuía, in icuac tiquitaz xictlacolhui xicholo. —Axan ye oniccac tlenon nicchihuaz inicuac niquitaz in tecuani; axan ayocmo niquilcahuaz.	Haz como te digo, y cuando lo veas, aléjate de él. —Ahora ya oí lo que debo hacer cuando vea al lobo. ~~~ Ahora ya no se me olvidará.
Open papaqui tetentzicuini. —Nana —quitohua cacapizcayotl— , nozo tinechmocahuiliz moztla nipaxialotin. —Icanica ticnequi tiaz?	Y empezó a saltar de gusto. —Mamá —dijo el zorrito—, ¿por eso me dejará usted mañana salir a pasear? —¿Por dónde quieres ir?
Ye yalhua ye otimitzilhui tía nehuatl amo niquizaz, amo cana tiatica.	Ya te dije ayer que si yo no salgo, no irás a ninguna parte.
Moztlatica za ce onquiz huan quilhuía inan: —Axan nia nipaxialotin, huan tía ye niquitta in tecuani, tlenon nicchihuaz?	Apenas amaneció, le dijo a su mamá: —Ahora voy a pasearme, y si veo al lobo ¿qué cosa hago? ¿lo saludo? —Que no; ya te dije que te retires y escapes corriendo. —Está bien, mamá.
Nitetlapaloz? —Amo; ye otimitzilhui, xictlacolhui huan xiquiztiquiza. —Cualica nana.	Salió el zorrito a pasear por todas partes, y por donde iba nomás miraba asustado y cuidándose.
Oquiz cacapizcayotl opaxialoto ica nohuian huan icanica oyaya zan omocatlachixtaya motlatachilía, neci ye oquimatia ye oquitaya icanica oyaya huan oquicaquia otlatzanatzaya ahuaxihuitl; omomanía nepa canican mocatlachia ixtepepelahui huan occepa opehuaya nenemi.	Parecíale que se le iba a aparecer por donde iba y creía oír que hacía ruido en la hojarasca de encino y se detenía.
Zazan huele oquilnamictaya in tecuani zan animatetecuini ica oyataya.	A todas partes veía asustado y luego otra vez echaba a andar.
Huan hueliz quimach onene orne huan tlaco necehuilli icuac oquitac itzalan tlacoyo huan alhuame, ompa ye 22oyuhtaya nin tecuani, zan ye yehuatl non cecpa oquiititi inana.	Nada más se acordaba del lobo y le brincaba de susto el corazón por donde iba andando.
Tlen oquichin oquiztiquiz capizcayotl huan ocalaquito ichan; zan mocuitlapil etequetzi; niman oquilhuito inana: —Nana, ye oniquittac none tlen itoca? —Tlenon otiquittac?	Y habría andado dos y media leguas, cuando lo vio en medio del breñal y los encinos; allí 23estaba yendo el lobo, el mismo que una vez le había enseñado su mamá.
Xinechilhui. —Inon yolcatl. —Tlen itocayo?	Lo que hizo el zorro fue escapar corriendo y meterse en su casa.
Coyotl? —Amo. —Ya tlenon nozo? —Amo niquilnamiqui. —Huey miztli? —Amo; quinozo tlenon. —Hueliz tecuani? —Inon, inon tecuani! —Ica Dios ihuelitzin amida omitzchihuilli! —Amo, tía yehuatl amo nechitac, tía nehuatl oniquitac huan onalcholo. —Ye otimitzilhui amo cana xiquiztinemi mocecelton, tlamo quemanian ayocmo ticalaquiquin. —Melac nana, ayocmo cana niaz huan tía niquizaz ayemo hueca notlapoz, za ica nican nipapaxialotin.	Iba con la cola levantada. ~~~ Luego le dice a su mamá: —Mamá, ya lo vi, ése, ¿cómo se llama? —Qué cosa ya viste?, dime. —A ese animal. —¿Cómo se llama? ~~~ ¿Coyote? —No. —Pues, ¿qué cosa? —No me acuerdo. —¿León? —No, no sé qué. —¿Puede que el lobo? —Ese, ése, el lobo. —Por obra de Dios, no te hizo nada. —No, si él no me vio, mientras que yo sí lo vi y eché a correr. —Ya te dije que no salieras solo a ninguna parte; si no, alguna vez ya no volverás. —De veras, mamá, ya no iré a ninguna parte, y si salgo, ya no me iré muy lejos, nada más por aquí cerca me pasearé.
Moztlatica occepa oquiz, ya amonpa oyeya inana.	Al otro día volvió a salir, pues no estaba ahí su mamá.
Omotlalota ica nohuian que achtopa zan opapatlacapa neci oquimatia ye oyaya quitaz occepa in tecuani.	Se fue a andar por todas partes, y como la primera vez, temblaba todo él. ~~~ Parece que presentía que iba a ver otra vez al lobo.
Melac hueliz quimach tlatlaco otli oyaya icuac oquicac oquinmimiloque cequi teme.	Y de veras, apenas iría a mitad del camino, cuando oyó que echaron a rodar algunas piedras.
Ocachi ye omocamic omoma huan otlachiaya in icanica otecuepque huan oquitac zan ye yehuatl tecuani, ompa icatica huan otlachiaya icanica oquitac cente cuapitzo ye oyaya caciz.	Se espantó más y se detuvo a ver por dónde habían caído las piedras. ~~~ Y vio que era el mismo lobo que ahí estaba parado mirando por dónde se había ido un jabalí que iba a cazar.
Huan nin tecuani amo oquitaya capizcayod, huan capizcayod ayecmo oquimatia tlenon, quichihuaz, za que cuatepolli omocan, neci ayocmo tlalpa onemia, neci oquimatia nochi icxihuan ye ocepoque.	Y el lobo no veía al zorro, y el zorro no sabía qué hacer; se quedó hecho un tronco, parecía que ya no estaba sobre la tierra, le parecía que sus patas se habían congelado.
Yolic huan cualli oquicata in nemotilli huan occepa omoyolchican huan omopachota yolic huan cualli itlac tecuani, huan quilhuia capizcayotl: —Cualli tecuani, tlen taxtica?	Poco a poquito fue perdiendo el miedo y cobró ánimo otra vez, y, lentamente, se acercó al lobo y le dijo: —Buen lobo, ¿qué haces? ~~~ Entonces se volvió el lobo.
Imán omocuep tecuani, nin capizcayotl oquicualitac nin zan yehuatl omolhui: "Cuallica, cualli cempa tiatinemizque que cepan yani.	Gustóle al zorro y éste se dijo a sí mismo: "Qué bien estaría que anduviésemos juntos como amigos.
Cuacualtzin nin tecuani, huan quénin nonana onechilhui tlamictiani huan tecuani?	Es muy bonito este lobo, y ¿cómo es que mi mamá me dijo que mata y devora a la gente?
Amo melac; nehuatl nia nic tlapaloz.	No es cierto. ~~~ Yo lo voy a saludar."
Oqui tlapalo:—Quen otipanoc cualli tecuani? —Huan tehuatl que otitlahuilli capizcayotl? —Tlenon tictemotinemi ic oncan? —Nican notlayecahuilitica itzintlan nin cuacuahuitl. —Axan niquita que no nana amo oquipiaya tlenica onechilhuiani mocatzinco.	Lo saludó: —¿Cómo te va, buen lobo?—¿Y tú cómo amaneciste, zorro? —¿Qué andas buscando por aquí? —Aquí estoy descansando a la sombra de este arbolito. —Ahora veo, pues, que mi mamá no tenía por qué decirme mal de usted.
Otlato ihuan: —Tlenon omitzilhuique, noca otlato? —Amo onopachohuani itlac tecuani ya amo cualli tlacatl huan nechcuaz. —Mo nana nian niquixmati, nian mechixmati huan tleca iquión nocatlatohua?	Le pregunta: —¿Qué te dijo? ~~~ ¿Habló de mí? —Que no me acercara junto al lobo, que era muy malo y me devoraría. —A tu mamá ni la conozco, ni me conoce, ¿por qué habla así de mí?
Amo ximoneltoca; nehuatl cualli nitlacatl ica amehuan an tetelpocame quetehuatl.	No creas: yo soy bueno con ustedes los jóvenes como tú.
Nia timitzititiz que nehuatl cualli nitlacatl: xihuala ica nehuatl huan timitzititiz tlenon ticchihuazque, tiahue titlamotlazque, ocachicualli tehuatl ocachi tixihuian tiquinmotlaz zayoltin.	Voy a demostrarte cómo soy bueno; ven conmigo y te enseñaré qué vamos a hacer; vamos a cazar. ~~~ Lo mejor es que tú, por ser más listo, caces a los moscos.
Oquito que quema.	Dijo que sí.
Imán oquimamalti itepoz huan oyaque.	Luego cargó la escopeta y se fueron.
Hueliz quimach ce necehuilli huan tlaco onenenque, icuac oquinamic cente chichiton; zan que oquitac tecuani omotlati itic xicamac; huan chichiton quilhuia nin cacapizcayotl ipan inacaz: —Tía amo tihuian iccemi tipolitica. —Amo; tía ye otacaque otinquinmotlaco zazayoltin, huan tía ye nic mayahuiz cente nicquetzomaz, huan tía amo yehuatl nechquetzomaz. —Yeca! ~~~ Ye omitzcuamichaqui, tía ticmayahuiz onoce amo, yehuatl mitzcocotlancuacuaz.	Apenas habrían andado legua y media, cuando se encontraron con un perrito, que tan pronto como vio al lobo se escondió entre la hierba, y el perrito le dijo al oído al zorrito: —Si no te pones listo, estás perdido. —No hay cuidado; ya quedamos en ir a cazar moscos, y si yo cazo uno, lo morderé, y si no, él me morderá. —Ya está visto que te engañó; caces o no, él te morderá el pescuezo.
Oya chichiton huan oquincaten.	El perrito se fue y los dejó.
Za nepa onenenque huan oacito ipan ce ixtlahuatl huan oquilhui capizcayotl nin tecuani: —Tle amo ticnequi man titlamotlacan ica inin to tepoz huan tiquitazque tlamo iztlacati?	A poco caminar llegaron a una llanura y el zorro le dijo al lobo: —¿No quieres que disparemos con nuestra escopeta para probarla?
Quitohua tecuani: —Cuallica, xictlamotla tlen ticnequiz. —Ticnequi timotlalitin tehuatl huan iquión niquitaz tía cualli nitlamotla. —Ida occe xicmotla huan amo nehuatl.	Dijo el lobo: —Está bien; dispara sobre lo que quieras. —¿No quisieras ponerte de blanco para que yo pruebe a ver si tengo buena puntería? —Dispara sobre lo que quieras menos sobre mí.
Tle amo tiquitaz nehuatl nichiantic huan ticmotlaz ida iztac? —Ye otiquitac non nepa zayolli quimintica cente cuacue itzinpa?—Ye oniquitac —oeonito tecuani, masqui amo oquitaya. —Tía xic melahuilli in tepoztli huan xicmotla.	¿No ves que soy de color pardo y que debes disparar sobre algo blanco? —¿Ya has visto a ese mosquito que está picando a ese buey en un anca? —Ya lo vi —contestó el lobo, si bien no lo veía.
Capizcayotl oquitlalilli tepoztli itlacual ihuan oquimotlac.	
Imán otzatzic capizcayotl huan oquito: —Onicmacac ipan ixci.	Apúntale con la escopeta y tírale.
Huan xihualmica tehuatzin, cualli tecuani.	Cargó la escopeta el zorro e hizo fuego.
Huan otzicuintin quename ce mazad; huan quimach otzicuinque tlaco necehuilli, icuac oquitaque cente cuaque ozacacuatinemia.	Luego gritó el zorro diciendo:—¡Le pegué en una pata!, ¡Venga usted, amigo lobo! —dijo el zorro, y echó a correr como un venado.
Huan omopachota capizcayotl itlac cuacue huan quitlatlanti ica ce cualli: —Cualli cuacue, tle amo otimotilli iconcan cente huey zayolli? ~~~ Quitohua cuacue: —Quen amo niquitaz!	Habrían corrido cosa de media legua cuando toparon con un buey que andaba paciendo por allí. —Buen buey, ¿no ha visto usted por aquí un gran mosquito?
Huan amo zan oniquita no iqui onicac otzatzitaya nelli oquimotlaque ipan cente ima huan oquicotinilique; hueliz ipan omochin icuac onicac ic oncan notlac ozolontiquiz itlacual tepoztli.	Dijo el buey: —¡Cómo no iba a verlo!, ¡Y no solamente lo vi, sino que lo oí gritar que le habían dado un tiro en una mano y se la habían roto!
Imán inon oquicac tecuani, omocamic, zan ixquiquiza, oconitaya Capizcayotl huan oquitohuaya tecuani: —Axan man tiacan canin oticonitoque.	
Onahuat capizcayotl: —Tlen taitihue zazan hueca?	Entiendo que esto ocurrió en el momento en que oí zumbar una bala.
Zan nican tóncate, tlaxquita mopan ticpia cente zayolli; ximochia man niquitilli.	Cuando escuchó esto el lobo se asustó y, espantado, sacando tamaños ojos, veía al zorro y le dijo: —Ahora vámonos por donde habíamos dicho.
Imán oquitiliaya, otzicuinten huan hueca omomanato huan papatlaca.	Contestóle el zorro: —¿Y a qué vamos a ir tan lejos? ~~~ Quedémonos aquí.
Quitohua capizcayotl: —Tlen oticonitoque ye oticonitoque, amo ximoolini, ximochia, tlamo ipan moticalactiquizaz itlacual tepoztli.	¡Mira, se ha parado sobre ti un mosquito!, ¡Espera, voy a tirarle!, Luego que le apunta echa a correr y deteniéndose a alguna distancia, le dice al zorro, todo tembloroso: —Lo dicho, dicho.
Oquilnamic Tecuani quénin moquixtilliz ica capizcayotl, oquican tatapahui capizcayotl, quilhuia: —Axan niquilnamictica, onican nonaca itic nocal, huan amo onictzacten.	No te muevas, espera, ¡que no vaya a escaparse el tiro de la escopeta! ~~~ Entonces se le ocurrió al lobo decirle al zorro, para quitárselo de encima: —Ahora me acuerdo de que dejé mi ración de carne en la casa y me olvidé cerrar la puerta.
Inon oquito imán oquitac capizcayotl oquitiliaya.	Eso le dijo cuando vio que el zorro le apuntaba.
Tecuani quitohua: —Xinechchía, ye nihuitz.	Le dijo el lobo: —Espérame, ya vengo.
Oquiztiquiz oya, omocaltzac ichan; ayoquic omocalacti inca occequin yolcame; tlamo quemanian oquimictiani.	Y se escapó corriendo a encerrarse en su casa y ya no volvió a salir ni a meterse con los demás animales por temor de que lo matasen.
[END OF DOCUMENT].	[END OF DOCUMENT].
[NEW_DOCUMENT: DOCid=2, lang=nah, DOCNAME=TOTOCHTLI HUAN MAZACUATL ].	[NEW_DOCUMENT: DOCid=2, lang=spa, DOCNAME= EL CONEJITO Y LA CULEBRA ].
TOTOCHTLI HUAN MAZACUATL .	EL CONEJITO Y LA CULEBRA .
Cecpa cente totochtli oquiz itic itlacoyoc; omotlacualtemoliaya ica ixtlahuapa zacacuatinemía, in icuac oquitac ye ohualaya ce cualli quiatepozcatli.	Una vez un conejito salió de su agujero; se iba en busca de su comida por el llano. ~~~ Estaba comiendo pasto y cuando advirtió ya venía un buen aguacero.
Tlen oquichin?	¿Qué fue lo que hizo?
Oya omotlatizquía itic cente ooztotl; inin amo oquimatia tía ompa oyeya cente mazacuatl.	Se fue a esconder dentro de una cueva. ~~~ El no sabía que ahí dentro ya estaba una culebra.
Ye oquimatia que icuac ce cualli huepahualiztli quipia, ayic zan cacalacti ipan zazo tlen chantli, achtopa te tlapaloa, huan tía quinanquilía calaqui, huan tía amo te nanquilía, amo calaqui.	Sabía, sí, que cuando uno tiene buena educación, nunca se mete uno sin más ni más en una casa [sino que], primero se saluda y, si le contestan, entra y, si no le contestan, no se entra.
Icuac oacic caltenco ooztotl, tlen oquichin tetlapalo: —Ma niquito oquitlapalo cualli ooztotl.	Cuando llegó a la cueva lo [primero] que hizo fue saludar. —Le diré un saludo a la buena cuevita.
Quilhuía: —Quen otipanoc, cualli ooztotl, quien otitlathuilli?	Le dice: —¿Cómo lo has pasado, buena cuevita, cómo amaneciste?
Onahuat in amocualli mazacuatl: —Cualli, tlazocamati; xicalaqui cualli totochtli; quen otiquilnamic que otinechtlapaloco?	Contestóle la malvada culebra: —Bien, muchas gracias; pasa, buen conejito; ¿cómo es que te acordaste de venir a saludarme?
Xihuala.	¡Ven!
Nin mazacuatl oquilhuiaya man calaqui, in icuac ocalaquini in cualli totochtli, oquicuani.	Aquella culebra le decía que entrase [para] que cuando entrara el buen conejito [poder] comérselo.
	El conejito, [que] ya la había husmeado antes, se echó a temblar.
Totochtli achtopa ye oquineuc, oyen ye papatlaca.	Entonces contestóle el conejito diciéndole: —Deje usted.
Imán onahuatl, totochtli, quilhuía: —Zan nican ximocahuilli, ya omniquita que neci zan panoz inon quiatepozatli. —Amo tonmotlapaltiliz, ocachi cualli ximoquiatlatiqui. —Cualli ooztotl, xinechilhui: tle oztome nahuati? —Oztome amo tlatohuani. —Tlazocamati huelmiac; ye nia.	Solamente aquí veo que el tiempo cambió, que al parecer ya va a pasar la tempestad. —No vaya a ser que te mojes; lo mejor es que te guarezcas de la lluvia. —Buena cuevita, dime; ¿que las cuevas hablan? —Las cuevas no hablan. —Muchas gracias; ya me voy.
Totochtli oquiztiquiztiquiz; zan mo cuitlapil quetzti oya.	El conejito se fue corriendo, con la colita muy parada.
Huan mazacuatl omocan itic oztotl huan oquitohuaya: —Ocachi cualli amo onicnanquiliani; onicahuani ocalaquini huan iquion onicua.	Y la culebra quedóse en la cueva y se decía: —Mejor hubiera sido no contestarle [sino] haberlo dejado entrar y así me lo habría comido.
Nitetica, ni tetemitl!	¡Soy muy tonta!
Huan otlahuelmic tleca ahuelli oconcua totochtli.	Y se enojó porque no había podido comerse al conejito.
Axcan totochtli zan ye zacacuatinemi ica ixtlahuapa.	Ahora el conejito anda por el campo comiendo pasto.
40 [END OF DOCUMENT].	41 [END OF DOCUMENT].
[NEW_DOCUMENT: DOCid=3, lang=nah, DOCNAME=TLATZICAPILTONTLI HUAN TOTOCHTLI ].	[NEW_DOCUMENT: DOCid=3, lang=spa, DOCNAME= EL MUCHACHO PEREZOSO Y EL CONEJITO ].
TLATZICAPILTONTLI HUAN TOTOCHTLI .	EL MUCHACHO PEREZOSO Y EL CONEJITO .
Ipan ce altepetl ochantía nin tlacapa, te cihuan huan cente teconen.	En cierto pueblo vivía este señor, su esposa y un hijo suyo.
Inin tlacapa momoztla ohuilaya on tlachialoya mila, ocuicaya tlazolli, icuitlatl cahauyo huan cuacue.	Este señor iba a diario a ver su sementera, llevábale mantillo, estiércol de caballo y de res.
In icuac otlamolonianía inon xihuitl ye cualli otocani: huan inon cahuayocuitlatl, tlazolli huan cuacuecuitlatl oquitotoniliani huan omochihuani.	Así, cuando barbechó en ese año ya pudo sembrar, y el estiércol de caballo y el mantillo y la boñiga darían color y madurarían los frutos.
Icón oquichique.	Así sucedió.
Oacic in metztli otocaque huan ipan caxtolli tonalli oixhuac tlaolli, etl, xictomatl, tomad, chilchotl xoxoctic huan opeque tlacuica itic in milli, mitotía, otlahuanque in icuac otlatlalhuique.	Llegó el mes de la siembra y a los quince días nació el maíz, el frijol, el jitomate, el tomate, el chile verde, y se cantó en la sementera, y se bailó.
Oncan ye oquitlalique in zacacacalli canin omoquiatlatiaya.	Se embriagaron cuando taparon.
Huey piltontli oquixotiaya milli; ame calaquizque yolcame.	Entonces pusieron allí una casa de paja para guarecerse de la lluvia.
Yehua inon oquilhuiten itata, man tlaixoti.	El muchacho debía cuidar de la sementera, que no entrasen los animales.
Inon yohualli ompon ococh.	Así se lo ordenó su papá, que cuidase.
Amo oquimat, quenin nian cani ocalaque totochtin, niman ce cuemitl oquicuaque.	Aquella noche allí durmió y no supo ni cómo ni cuándo entraron los conejos y luego se comieron un surco.
Inin totochtin, icuac ocalaque itic milli, amaca oquinahuac nian aquin itla quimilhuiz.	A estos conejitos, cuando entraron a la sementera, nadie los regañó ni nadie les dijo nada.
Oncan otlanez huan tlatzica piltontli oquimalacachoto imil, oquitac ye oquicuaque, tlen nozo yolcahuan, ce cuemitl etl.	Después amaneció y el muchacho perezoso fue a dar la vuelta por la sementera y vio que ya se habían comido, quién sabe qué animales, un surco de frijol.
Huan ichan inana, zan ocuatzinco, onehualoya tlaxcalmalo huan zan icihuihua oquititlaniliaya momoztla itlaxcal huan emulli, inaca, tlen za nelli miltlapixqui, ame mocahuaz ce tonalli amo tlacuaz: —Man cuiquilican zan ocuatzinco.	Y en su casa su mamá, muy tempranito, se levantaba a hacer las tortillas y se apuraba a mandarle todos los días sus tortillas y su mole de frijol, su carne, que porque él estaba cuidando la sementera, que no fuese a suceder que se quedase un día sin comer: —Que se lo lleven tempranito.
Huan niman, nin tlatzica piltontli, ichan amo oquimatia tía zan moteteca ipan tonalli.	Y luego, este muchacho flojo, en su casa no sabían que sólo estaba acostado al sol.
Ayecmo machía tlenon quichíaz, tlenon quintlaliliz inon yolcame, tía quinpacuatiz, quinmotlaz, onoce quinahuatiz itata, huan amo no oquinequia tenahuatiz tlamo oquitecuini.	Ya no sabía qué hacer, qué cosa ponerle a esos animales, si envenenarlos, cazarlos o avisarle a su papá, y no quería avisarle a su papá, no fuese a pegarle.
Totochtli ye oquimatia canin otlayeya.	El conejito ya sabía en dónde había.
Cecpa oquiz ica ixtlahuapa hua oquinnamiquito cicitin huan quimilhuiti: —Tlen amay, cualli cicitin? —Amida, cualli totochtli;. tlenon otaico icanican?	Una vez salió por el campo y se fue a encontrar a las liebres y les dijo: —¿Qué se hacen, buenas liebrecitas? —Nada, buen conejito, ¿qué viniste a hacer por aquí?
Onipaxialoco, cicitli. ~~~ Cualli totochtli, tehuatl amo ticmati canin cualli tonyazquia ipan itla milli ticoncuazquia itla occe non cana tocani non cualli daca que etl, tlaolli, itla huelli huan tzopelic? —Quenamo!	Vine a pasear, liebrecita. —Buen conejito, ¿tú no sabes a dónde podríamos ir, a alguna sementera a comer cualquier cosa, en donde siembren esos buenos hombres, como frijol, maíz, algo sabroso y agradable? —¡Cómo no!
Tle anquinequi anyazque?	¿Quieren ustedes ir?
Nia namechhuica 56huan amo zan amehuan anyazque, ye oniquintlalhui occequin yolcame huan ye onechnanquilique cepan tiazque. —Oya cuallica —oconitoque cicitin—; huan aquinome inon yolcame? —Nia timitzilhuiz: cente techalotl, nocnihuan totochtin, none cuecuezama, pezotli, inime cana matlactin non incelpezotin, mazatl, tlalcoyotl huan ocachtin ayocmo niquilnamiqui, zan ye tiquimitaz canin ye otolhuique, tonamiquitihue. —Canin? —Tlaxquitta, tiixtlamati tequizquiopan inon milli inepantla quipía cente tamazquitl tomahuac, huei, huan mamaye xoxoctica paqui tlayecahui tlatlayohuatica. —Ompa timitzchía inca occequin, xiquintlalhui huan ca yohualli ompa tonamiqui; amo tomanahuatía, ya totazque canin ye ticmati. —Ye nia.	
Ocacic tochtli ica ipan tlatlatelli, oya.	Yo las llevaré; no sólo irán 57Tlalcoyote.
	Pequeño cuadrúpedo parecido al perro y a la zorra, que se esconde bajo tierra. ~~~ (Siméon, p.
Yolcame ye omotlalhuique inon yohualli mocentlalizque huan cualli huetzitihue itic non milli oyectoctitaya.	540; Molina, p. ~~~ 124, 2a. parte.)contento el muchacho perezoso de haber puesto la trampa con la que esperaba coger a los animales.
Noca yolcame motlatlalhuía nican, tlatzica piltontli ye ocia tlatlani nepa canican ica occequi tlatlacapa occequin miltin non oquinyohualotaya imil, oquimitaya ipan in mil huan oquintlatlaniaya: —Notatzin, tle amo timomachitía tlenon huelliz cualli niquintlalilliz yolcame ye quitlamía nomil? —Tlaxquitta, nia timitzmacaz ce amo cualli tlatolmacaliz, xicaqui: xiquitta tlen iyolcayohuan calaqui, tía mazatl no ce cuacue, pitzome.	Luego, cuando oscureció por la noche, primero llegaron las hormigas cabezonas, y entraron por donde estaba la trampa, pasaron la trampa y nada, no cogió ni una hormiga; en seguida llegaron los ratones y cuando pasaron en medio de la trampa olieron la grasa que había en la trampa, luego empezaron a roerla.
Icanica calaqui? —Itzintlan cente tepamitl. —Oya xicchihua que timitzilhuía, cente tzohuazth. —Nia nicchihuaz niman. —Mazqui cemilhuitl man ye —oquitoque tlacapa—, amo quichihuilía.	El muchacho engrasó la trampa, creyendo que eso era lo mejor, porque con la grasa resbalaría y se cogería al ladrón.
Tlatzica piltontli oya imil, oquitlalito in tzohuazth itenco tlacoyoctli, oquitlali tzohuazth zazan tlapoqui, zan papaqui tlatzica piltontli ye oquitlali tzohuazth, nelli ica macizque yolcame.	Tan pronto como los ratoncitos la royeron con sus dientes y probaron que no estaba sabrosa, la dejaron, y siguieron de nuevo su camino.
Imán ye tlatlapoyahui ica teotlacan, achtopa oecoque tzicame cuatalame, huan ocalaque icanica oyeya in tzohuazth, itic tzohuazth opanoque huan amida, nian cente tzicatl amitla omacic; oncan oecoque quiquimichtin huan icuac opanoque itzalan tzohuazth,oquineque chiahua ahuiac in tzohuazth; imán opeque quitetexohua.	
Nin piltontli oquichían in tzohuazth, nelli iquión ocachi cualli motlaloz huan maciz ichtequi.	Llegados a la sementera comenzaron a roer, a roer, a roer y el muchacho dormía como si estuviese muerto.
Zan que ye oquitlantetexoque quiquimichtin huan oquicamamatque amo huelic, oquicateque huan occepa oquitocaque imohui huan oacito itic milli, opeque tlatequi, tlatequi, tlatequi, huan piltontli cochmictica.	Se vieron junto al viejo madroño todos los animales; ya se habían reunido en la noche los tejones, el armadillo, el conejo, la liebre, el tlalcoyote, el zorro y otros animales más.
Omixtique itzin tamazquitl huehue mochtin yolcame, ye omocentlalitaya in ica yohualli pepezotin, ayotochtli, tochtli, citli, tlalcoyotl, oztohua, huan ocachtin yolcame.	Cuando estuvieron todos juntos, se formaron en fila; el venado iba al frente.
Imán nochtin ye omocentlalique, omotecpanque, mazatl oquinyecanaya.	Cuando llegaron a la orilla de la sementera, dijo el venado: —Hagan alto un rato, que pueda yo escuchar si viene alguno.
Imán oacique itenco milli, quimilhuía mazatl: —Ximoquetzacan tepitzin, man nontlacaqui tía acá huitz.	Se paró y se puso a oír y dijo: —No oigo nada, ni veo nada; apresurémonos, ya estamos a la orilla de la sementera.
Omoma huan tlacactica, quimilhuía: —Amida nicaqui, nian amida niquitta; tocxianacan, ye itenco milli ticate.	Llegaron y les dijo el venado: —Yo voy a saltar como si volara y ustedes verán cómo no tiro ni una piedra.
Oacique huan mazatl quimilhuía: —Nehuatl zan nitentzicuiniz zan que nipatlaniz huan anquiittazque que nian cente tetl amo nictlacaliz.	Así sucedió, realmente, y los demás pasaron también; unos por encima de la cerca, otros metiéndose por el hoyo.
Melac opanoc, huan occequin no opanoque, cequin ica icpan tepamitl, occequin ica itic tlacoyoctli.	Entraron de prisa, todos come, y come, y come, y el muchacho dormido como una piedra, no oía nada.
Niman ocalactiquizque huan tlacua, tlacua, tlacua, huan cochmioque tetl piltontli amo manel oquincaquía.	Al día siguiente se levantó y fue a ver su sementera.
Moztlatica ornen huan on tlachix ica pan imil, occepa ye otlacuato; oquitato tzohuazth huan quitoti: —Niquitzdcac que miactin ohualaque yolcame; manel cente ye omacic.	Otra vez se la habían comido; fue a ver la trampa y dijo: —Lo que veo es que fueron muchos los animales que vinieron; quizá haya caído alguno.
Oconitac tzohuazth, nochi ye oquitlanteque.	Examinó la trampa y vio que estaba toda destrozada con los dientes.
Ayecmo quimati tlenon quichihuaz.	Ya no sabía qué hacer.
Occepa, oquintlatlanito, quenin quichihuaz, zan que nochipa calaqui huan tlacua, quicua in milli. —Xiquinpacualti. —Nia niquintlaliliz.	De nuevo fue a preguntar qué debía hacer, puesto que de todos modos los animales entraban a comer y se comían su sementera. —Dales veneno. —Voy a ponérselos.Se los puso, y ni así.
Oquintlalili huan nian iquión. ~~~ Occepa ye oquintlatlanito, quilhuía: —Ye tiquintlamía yolcame? —Amo; zan oquitlacaltiquizque huan amo oquicuaque. —Huelliz amo in tlacual, xiquintlalilili ayotli ica chichipatli.	Y otra vez fue a preguntar, y le dijeron: —¿Ya acabas con los animales? —No; nada más tiraron por el suelo la comida envenenada y no la comieron. —Puede ser que no sea eso lo que coman; ponles calabaza con digital.
Oquintlalili huan nian iquión.	Se las puso y ni así.
Occepa oquintlatlanito huan quilhuique:Tía amo quinchihuilía nochi tlen ye otiquintlalili, tlen ticchihuaz ocachi cualli huan amo moca huetzcazque nian papaquizque, ximocohui cente tepoztli huan xiquinpipía icuac calaqui.	Otra vez fue a preguntar, y le dijeron: —Si en nada aprovecha cuanto les has puesto, lo mejor que has de hacer para que no se rían de ti ni se diviertan contigo es comprarte una escopeta y espiarlos a la hora que entren.
Niman omocohui itepoz.	Luego se compró su escopeta.
Moztlatica oquinpipiaya ica yohualli huan inon yohualli amo ocalaque.	A otro día estuvo al acecho por la noche y esa noche no entraron.
Ye opapac ica inon, oconito ayocmo calaquizque, oquinnahuatito.	Con esto se alegró diciendo que ya no entrarían y así fue a contarlo.
Ocacalacta inchan huan te intlapalo, ocalac huan quimilhuía: —Namechhuiquiliz ce yancuic tlanahuatilli, inin yohualli ayocmo ocalaque ipan nomil inyolcame. —Ya amo otimitzilhui?	Llegó a su casa, saludó, entró y dijo: —Traigo a ustedes una nueva noticia: esta noche los animales ya no entraron a mi sementera. —¿Pues no te lo dije, que con la escopeta es mejor?
Ica tepoztli ocachi cualli haun tía calaqui zan que tiquimitaz, xiquintlacueponilli huan iquión mocacuizque huan ayecmo calaquizque. —Tlazocamati huei miac; ye nia.	Y, si entran, en cuanto los veas hazles fuego y así se espantarán y ya no volverán. —Muchísimas gracias; ya me voy.
Ipan occe yohualli oquitac amo ocalaque; ipan occe yohualli omotlalicochi imán occepa ocalaque.	A la noche siguiente vio que no entraron; y a la siguiente se puso a dormir y entraron otra vez.
Moztlatica, icuac otlanez, occepa ye otlacuato itic milli.	Al día siguiente, cuando amaneció, vio que de nuevo se habían ido a comer su sementera.
Imán ocualan, huan ayecmo non tlacatl otetlatlaniaya, occeni otetlatlanito.	Entonces se enfadó, y ya no fue a preguntarle a aquel señor sino que fue a preguntar a otro.
Ocalaquito ipan occente calli huan oquintlatlani: —Namechtlatlanico tlenon nicchihuaz, ye quitlamía nomil yolcame. —Tleca? —Ye oniquintlalili tzohuazth; ye oniquinpacualti, nian iquión. —Axan xiccohua cozticxicocuitlatl, huan xicchichihua cente coconetl, xictlali icanica calaquini huan tiquitaz que iquión huetziz.	Entró a otra casa y preguntó: —Vengo a preguntarles qué he de hacer; ya están acabando mi sementera los animales. —¿Por qué? —Ya les he puesto trampas, les he echado veneno a comer y ni por ésas. —Ahora compra cera amarilla y haz un muñeco, ponió en el lugar por donde entran y verás cómo caen.
Melac oquicohuato tlen oquilhuique; oquichichin in coconetl huan oquitlali itenco tlacoyoctli, huan moztlatica otlachiato.	Y, de veras, fue a comprar lo que le dijeron, hizo el muñeco y lo puso a un lado del hoyo.
Ayecmo omacía; ompon oquican.	Aun así no cayó; y allí lo dejó.
Occepa icuac oacic in tochtli huan oquinequía panoz huan quilhuía in coconetl: —Nia nipanoz, ximocuani.	En otra ocasión, cuando llegó el conejo y quiso pasar, le dijo al muñeco: —Voy a pasar, quítate.
Amo nahuati coconetl. —Tle amo titlacaqui que ximocuani?	No contestó el muñeco. —¿Qué no has oído que te quites?
Tlamo, timitzxayacatlatziniz. ~~~ Amo nahuati —Tehuatl amo titlacaqui?	Si no, te daré un manazo en la cara.No contestó. —¿No oyes tú?
Totochtli oquixayacatlatzini huan omotzico ima ipan coconetl. —Xinechcacahua, tlamo axan tiquittaz quen mopanyaz, ica occente noma timitzmomotzoz.Amo nahuati coconetl. —Amo titlacaqui timitzmotzoz?	El conejito le dio una bofetada y su mano se quedó pegada en el muñeco. —Suéltame, y si no, ahora verás lo que te pasa: con mi otra mano te rasguñaré. ~~~ No contestó el muñeco. —¿No oyes que te voy a rasguñar?
Oquimomotzo huan occepa omotzico, ye ica orne imahuan otzicataya, quilhuía totochtli in coconetl: —Ye ocpa otimitzilhui xinechcacahua; amo ticnequi?	Lo rasguñó y se quedó pegado otra vez; ya estaba pegado con sus dos manos; entonces le dijo el conejito al muñeco: —Ya te he dicho dos veces que me sueltes, ¿no quieres?
Tehuatl ticmati nehuatl nia timitzteliczaz que xinechcacahua.	Sábete que voy a patearte, ¡que me sueltes!
Coconetl amo nahuati. —Zan noca tihuehuetzca!	El muñeco no contestó. —¡Nada más te estás burlando de mí!
Amo tinechcacahuaz, timitzteliczaz!	¡No me sueltas, pues te pateo!
Oquiteliczaz huan occepa omotzico. —Amo tinechcacahuaz?	Lo pateó y otra vez se pegó. —¿No me sueltas?
Amo nahuati. —Tlamo tinechcacahuaznequi timitzteliczaz ica occente nocxi.	No contestó. —Si no me quieres soltar te patearé con mi otra pata.
Tehuatl amo timo neltoca?	¿Tú no lo quieres creer?
Amo nahuati coconetl. —Nehuatl neci niquita zan noca timahuiltía huan tinechtletlecalhuía.	No contestó el muñeco. —Lo que veo es que nada más te estás burlando de mí, arremedándome.
Axan quema ica notlancochhuan pintique huan tlatequini timitzcuaquetzomaz, ni timitzquetzomaz.	Ahora sí, con mis dientes aguzados y cortantes te morderé la cabeza; ¡voy a morderte, ya lo sabes!
Tehua ticmati! ~~~ Amo nahuati coconetl. —Axan melac za iti cecpa timitzilhuía, tinechcacahuaz onoce amo canin timitzquetzomaz mitzcocoz.	No contestó el muñeco. —Ahora de veras nada más te lo digo esta vez: o me sueltas, o te muerdo y te lastimo.
Oquiquetzo huan inca itlanhuan omoyectzico; imán open otlalmimilohua, yo cuelli mocacahua, caxilia in tlazalli icaomopilo, zan ye mo cueptinemi.	Lo mordió y con sus dientes quedóse más pegado; entonces empezó a revolverse sin poder soltarse. ~~~ Lo tenía preso la liga a que se quedó colgado y nada más se revolvía.
Icuac inon ipan omochihuaya ipan oacic piltontli miltlapixqui, huan quilhuía in tochtli: —Ye tehuatl otinechtlamili nomil, tecolotochtli; axan nehuatl nia timitzcuaz.	Mientras tal le sucedía, llegó el muchacho que cuidaba la sementera y le dijo al conejo: —Ya acabaste con mi sementera, conejo del diablo; ahora te voy a comer.
Oquiquitzqui tochtli huan oquitlalcueponi, omic; oquitlazocamachilli in coconetl coztic xicocuitlatl.	Cogió al conejo, lo aporreó contra el suelo y éste se murió. ~~~ Diole las gracias al muñeco de cera amarilla.
Imán oacic occe xihuitl, ye oquimatia quenin quimaciz yolcame non calaqui ipan miltin.	Cuando llegó el año siguiente, ya sabía cómo coger a los animales que entraban a su sementera.
[END OF DOCUMENT].	[END OF DOCUMENT].
[NEW_DOCUMENT: DOCid=4, lang=nah, DOCNAME=HUEYI MIZTLI, TLACOMIZTLI HUAN CAPIZCAYOTL ].	[NEW_DOCUMENT: DOCid=4, lang=spa, DOCNAME= EL LEÓN, EL CACOMIZCLE Y LA ZORRA ].
HUEYI MIZTLI, TLACOMIZTLI HUAN CAPIZCAYOTL .	EL LEÓN, EL CACOMIZCLE Y LA ZORRA .
	A la orilla de un pueblo, llamado Tepeoztotlan, al que rodeaban unos cerros, quedaba una cañada en donde vivían varios animales, entre los que de paso se encontraban coyotes, tejones, cacomizcles, lobos, una zorra, gatos monteses y otros animales que tenían por jefe un león.
Itenco ce altepetl itocayocan Tepeoztotlan.	Todos estos animales tenían por ocupación el robo.
Inin oquimalacachotaya occequin tepeme.	El león les daba sus órdenes.
Inin Tepeoztotlan omacahuaya tlatzalan canin ochantía yolcame.	
Que inime zan opanotinemía ompan, omonextiaya cocoyo, pezotin, tlacomiztin, tetequantin, cente capizcayotl, quamimiztin huan occequin yolcame.	A unos les ordenaba que fueran a traer ovejas, como a los lobos, y los coyotes cargaban con cerdos, los cacomizcles con gallinas y el tejón con fruta.
Inime oquinyecanaya hueyi miztli.	Estos animales querían al león.
Nochtin inin yolcame intequi tlachtecyotl.	
Inime oquintlatequimacaya in hueyi miztli.	
Cequin oquintequimacaya man oconcuini calnelotin, quename tetecuantin, huan cocoyo opitzozacaya, huan tepemaxtlame opiozacaya, pezotli xochicualzacaya.	Para que no se los comiera le llevaban de comer y así aquel animal ya no trabajaba, pues ya les había dicho que a quien no le obedeciere se lo comería.
Inime yolcame oquitlazotlaya in hueyi miztli, neli iquion amo quincuaz; oquitlacualzaquiliaya huan iquion inin yolcatl ayocmo otequitia, achtopa ye oquimilhui aquin amo quitlacaitaz, quicuaz.	
Huan cerne inon tonaltin oquizque que nochipa huan orne tlatlacomiztin ye ipan otli, omoxeloque tlen occequin yolcame huan cepan oyaque.	Y uno de esos días salieron como siempre y ya en el camino, dos cacomizcles se apartaron de los demás y se fueron juntos.
Inime yolcame nochipa huetzquiztoton huan huele mahuiltiani, oquitocaque imohui; opeque monomotza pan intlatlol.	Estos animales que siempre son muy risueños y muy juguetones, siguieron su camino y empezaron a conversar en su idioma.
Opanoque canica xochicualcuayo. ~~~ Inon occente ocachi tetencoli quilhuia non occente: —Noca oncan ticate ma tixochicualcuacan. —Techmictizque. —Amo quichihuilia. —Melac tle amo timoneltoca. —Quemanian quimach quinequi ce itla conanaz, niman quimictiz nequi, huan tía ye quimictia ce quipaxialoltia ipan altepetl, motlayehuia. —Tle melahuac? —Neci niquitta tehuatl amo queman timiqui. ~~~ Xitlamata! ~~~ Aquin nozo huitz! —Ayac huitz aquin ticnequi hualaz? —Mélac, nehuatl onimocamic.	Pasaban por donde había árboles frutales y, entonces, el más tonto le dice al otro: —Mientras estamos aquí, comeremos frutas. —Nos van a matar. —No le hace. —¿De veras, qué no lo crees? —¿Pero quién nos ha de matar? —A veces, apenas quiere uno coger alguna cosa, luego lo quieren matar, y si lo matan a uno lo pasean en el pueblo pidiendo limosna. —¿Pero qué es cierto? —Por lo que veo, tú nunca te has muerto, ¡Quieto!
Zan que omocencaque tlacua, oyaque; omoanque huan non ocachi hueyi quilhuía in occente: —Xitlatlamati, canin tiehue? —Amo nicmati canin tinechuica.	¡Quién sabe quién viene! —No viene ninguno, ¿quién quieres que venga? —De veras, yo me espanté.
12—Axan tiahue Tepemiltitla. ~~~ Huan amo oquimatia tía icuitlapan tepancuatl, oquincactaya cente chichiton. ~~~ Otlamáta inin huan oconito: —Ye oniccac canin yazque; axan niquinchiatin, niquinpipíaz nochan.	Tan luego como acabaron de comer, se fueron, cogieron su camino, y el más grande le dijo al otro: —¿Adivina a dónde vamos? —No sé dónde me llevas. —Ahora vamos a Tepemiltitla.
Inime quinichtequitihue no piohuan, amo ica quizazque; niquinpipíaz in yohualli.	13Barda de piedra.El cacomizcle no creía lo que le decían los perros.
Ocalaquito ichan; otlacua; oncan oquintlalhuito ocachtin chichime, quimilhuía: —Axan amechtlalhuico, ma nechnanamiquitihue; tiquinquitzquizque orne tlacomiztin, nicmati in yohualli tlachteuiquihue. —Zan ye, ompa xitechchía tiazque. ~~~ Oya in chichiton ichan, omotecato cochi.	Todavía estaba oyendo a los pollos roncar dormidos y un pollo estaba soñando y les decía algo a los otros, y los demás también le contestaban en sueños y uno de ellos les decía a los otros: —Miren, allí viene el gavilán, nos anda rodeando.
Yehuan opanoque zan ye mononotztihue. —Ye oticcac, tiazque Tepemiltitla ompa oniquimitztiquiz cuac onixaxococuato, ompa oncate cuacualli pióme, totomaque.	A lo que contestó el cacomizcle: —Si no es el gavilán quien los anda rodeando, sino yo, el cacomizcle, que los viene a saludar.
Amo cana niquimitztica que inon pióme.	Ya hace mucho tiempo que no los saludaba.
Axan ye otacico, aquin achtopa calaquiz tehuatl nozo nehuatl? —Zazo quénin ticnequiz. —Ye ticmati quénin ticquitzquiz pioton? —Amo. —Quemanian ye otiquitac quénin cochi? —Amoqueman niquimita. —Xiccaqui tlen nia timitzilhuiz; xiczalo, amo quemanian itla mopan mochihuaz.	
Icuac pióme cochticate, in tzonteco caquia itzintlan imahuitz, huan cuac ye oticalac huan itic piocallitiez zan cualli huan yolic huan ica tetlazotlaliztli, xicmatoca ica icuitlapa ipan iacol, huan niman izaz huan quiquixtiz itzonteco, huan zan que quiquixtia, xicquitzqui itech iquechcuayo huan niman, xictzicuinalti. ~~~ Noca nican timitzchía huan oncan nehua niaz nicanatin cente. ~~~ Oncacalacta occente huan yehuatl ocuatlecoc icpac tzapocuahuitl.	
Zan hueca quitztica noca occente ocalac itic piocalli.	Y muy cariñosamente, por la espalda, le tocó.
Nican chichiton no yoquinenec; open tlahuahualoa, niman ohualaque ocachtin chichime, oquiyahualoque in piocalli, huan oquilhuiaya chichime: —Xiquiza, tlacomiztli ichtequi. ~~~ Nican timitzmacazque tlen mohuazca ticnequi tiquitazque tiquixtiz in pioton! ~~~ Xiquiza, huan nican timitzcocototzazque ica totlancochuan.	Luego despertóse el pollo y empezó a gritar espantado, y los otros pollos también empezaron a aletear muy asustados y todos empezaron a dejarse caer de los palos en que estaban en el gallinero y se gritaban unos a los otros: —¡Despierten!
Tlacomiztli amo omoneltocaya tlen oquilhuiaya chichime.	¡Despierten!, ¡Quién sabe qué animal ya se llevó un pollito!
Oc oquincactaya pióme cochcuacualaca, huan ipan in cochiztliotlatemictaya cente pioton huan oquitohuaya in ocachtin pióme huan ocachtin pióme noiqui ocochtlatohuaya.	
Cerne non pióme quimilhuía in ocachtin: —Tlaxquitacan ne' huitz cuixi techmalacachotinemi.	Y el gallo se paseaba orgulloso en medio, paraba el pecho y cantaba: —¡Quiquiriquí!
Onahuatl tlacomiztli: —Tía amo cuixi amechmalacachotinemi, tía nehua ni tlacomiztli amechtlapaloco.	
Ye huecapa amo amechtlapallochuaya.	Y en su canto le dijo al cacomizcle: —¡Quiquiriquí!
Huan ica tlazotlaliztli oquicuitlapantzotzon, niman oizaten pioton huan open tzatzi, mocamiqui, huan occequin pióme noiqui opeque mopatlatza, mocamiqui, nochtin opeque motitiopancahua itic piocalli.	
Omotzatziliaya: —Xiizacan! ~~~ Xiizacan!	¡Ya te llevaste a una de mis mujeres!
Tlen nozo iyolcayo yotechhuiquili cente pioconetl. ~~~ Huan tequihua intzalan opaxialohuaya omeletequetzaya huan otlacuicac: —Quiquiriqui!	Y dirigiéndose a su esposa, le dice: —¡Cuando otra vez venga, conmigo tiene! —Ahora vino y nada le hiciste. —¡Tú cállate la boca!
Huan pan itlacuical oquilhui in tlacomiztli: —Quiquiriqui!	Y la pateó y les dijo: —Ahora ¡a dormir!, y les digo a ustedes cacaracacá, cacaracacá, ¡Que soy fuerte como no hay otro!
Yoticuicac cente no zohuan.	¡Yo soy valiente, aquí y en donde quieran!
Quimilhuía izohua: —Huan cuac occepa hualaz ica nehua quipia. —Axan ohuala huan amitla ottichihuili. —Huan tehua ximocamatzacua.	Mientras platicaba el gallo con las gallinas, he aquí que los perros en el corral ya habían matado al cacomizcle.
Oconteliczac, huan quimilhui: —Axan xicochican huan amechilhui cacaracaca, cacaracaca, Ni chichicacpol quen amonca occente.	Y el otro que estaba arriba del árbol de zapote, cuando vio que acabaron de matar los perros a ese cacomizcle, después luego se bajó corriendo de arriba del árbol de zapote y le fue a avisar al león.
Nehuatl nichapotl, nican huan zozocanin.	Le dijo: —Yo ya vine, y el otro que conmigo fue ya lo mataron.
Noca mononotza tequihua ihuan pióme, nican chichime ica ipan xolali ye oquinictique in tlacomiztli.	
Huan non occente icpac tzapocuahuitl oyeya, cuac oquitac ye oquicencahualtique chichime in tlacomiztli oncan, niman otemotiquiz icpac tzapocuahuitl, oquinahuatico in hueyi miztli, quilhuía: —Nehua yonihuala huan occente nohuan oya, oquimictique.	
Niman hueyi miztli oquilhui: —Axan tleca oticcaten, no tehuatl ticpia tlen timiquiz.	Luego el león le dijo: —Ahora, porque lo dejaste, también tú tienes que morir.
Quito tlacomiztli: —Cualli hueyi miztli, xiquinmonochili nochtin onozo occequin yolcame man yehuan quitocan.	Dijo el cacomizcle:—Bueno, león, convoque usted a todos, o a algunos de los otros animales, y que ellos digan.
Oquinnotz occequin yolcame huan niman ohualaque, omohuipanque huan ixtla omotoloque huan quimilhuía niman:—Tlacomiztli quipia tlen miquiz.	Llamó luego a los otros animales y luego se reunieron, se formaron y en su presencia se doblegaron y les dijo luego: —El cacomizcle tiene que morir.
Niman capizcayotl onahuat: —Huan tleca miquiz? —Oquimicti occente tlacomiztli. —Man quitocan occequin yolcame.	Luego la zorra preguntó: —¿Por qué debe morir? —Por haber matado al otro cacomizcle.
Onahuatque: —Quema cualli miquiz tlacomiztli; man quitlatlatolti in capizcayotl, huan tía yehua quipia tlatlacolli, quipia tlen miquiz.	Y contestaron los demás animales, que digan los otros animales: —Está bien que muera el cacomizcle; pero que le tome declaración la zorra, y si él tiene la culpa, tendrá que morir.
Hueyi miztli: —Manquitlatoltican.	El león: —Que le tome la declaración.
Onahuat capizcayotl, zanque oquitlatlatolti, quilhuia: —Tlamelac amo oticmaya ximotiopancahua icpac on tepetlatl. —Quema.	La zorra, después que le tomó la declaración, dijo: —Si de veras no lo has matado, déjate caer de arriba de ese tepetate. —Sí.
Nelli oquimalacachoto tepetatl tlecoz, noca oquitlapotaya in camac ica occecni, noca nican tlacomiztli ochólo ica capizcayotl.	Así fue a rodear el tepetate, para subir, y lo dejó abriendo la boca.
Huan hueyi miztli ohueyica cualan oque inon yoyolcame ica omahuiltique.	Por otra parte, mientras el cacomizcle se huyó con la zorra, y el león se enojó muchísimo de que esos animalitos se hubieran burlado de él.
Axan ye oquinnahuati non ocachtin inyolcahuan: —Canin quinamiquizque inon capizcayotl huan tlacomiztli, manquinpilocan ipan ce hueyi cuahuitl huan iquión motitizque quitlaca itazque in imacha.	Ahora, ya les avisó a los demás animales: —En donde encuentren a esa zorra y al cacomizcle, cuélguenlos en un árbol grande y así se enseñarán a obedecer a su jefe.
Axan quintemotinemi quintlachialtizque.	Ahora andan en su busca para escarmentarlos.
[END OF DOCUMENT].	[END OF DOCUMENT].
[NEW_DOCUMENT: DOCid=5, lang=nah, DOCNAME=HUEYMIZTLI HUAN TECUICUICA ].	[NEW_DOCUMENT: DOCid=5, lang=spa, DOCNAME= EL LEÓN Y EL GRILLO ].
HUEYMIZTLI HUAN TECUICUICA .	EL LEÓN Y EL GRILLO .
Hueyi miztli ohuetztotaya, oyetaya, oncan ometen omocamic otzicuin huan Tecuicuica ocotaya itic itecpancalco.	El león estaba echado, allá estaba; luego se levantó corriendo, asustado y [mientras] el grillo estaba en su palacio.
Tetecuicuica otentzicuin huan oquitzatzilli, oquilhui: —Ximonana!	El grillo brincó, le gritó y le dijo: —¡Detente!
Amo xicholoya! ~~~ Nehuatl nitzitziquitzin, zan onicxico nopan otichocholo.	¡No huyas!, Yo soy pequeñito, pero supe resistirte cuando me pisaste.
Axan, quen ticchihuazque? —Nozo, quenin ticchihuazque? —Nicnequi axan tinechyectlaliliz notecpancalco. —Amo timitzyectlaliliz. —Amo?	Ahora, ¿qué haremos? —Eso es, ¿cómo hemos de arreglarlo? —Quiero que ahora mismo me compongas mi palacio. —No he de componértelo. —¿Qué no?
Ticyectlaliz huan tlamo tiquittazque. —Ya!	Tú lo compondrás, y si no, ya nos veremos. —¡Bah!
Tlen tinechchihuilliz? —huan ohuehuetzcac. —Quen ticnequi timitzyectlaliliz?	¿Qué me has de hacer? —y se rió [el león].
Tlaxquitta, tocepan yazque. —Tle!	¿Cómo quieres que yo te lo componga?
Mellac cualli! —Ahuelli, tiquitohua tehua, huan tía ticnequi tiquittazque zan xiquito. —A qué tehuatl!	Mira, vámonos juntos. —¡De veras que eres ocurrente! —No tienes que decir nada y si quieres veremos [quién gana], ¡nada más habla! —¡Ah, qué tú!
Tiehue tipaxialohua!	Vamos a pasear.
Oyaque, oacique pan cente atlatli, oquito hueyi miztli: —Tía ticnequi nican ticualitacan, cualtitentzicuinican nehuatl ica tehuatl. —Quen amo, xinechyecana. —Nitentzicuiniz, xinechontoca.	Se fueron juntos y cuando llegaron a una barranca, dijo el León: —Si quieres aquí veremos [quién gana]; brinquemos juntos, yo y tú. —¡Cómo no!
Otentzicuin hueyi miztli.	¡Ve tú delante! —Voy a saltar.
Tecuicuica omotzico itech icuitlapil huan imán otentzicuin, ohuetzico ocachi hueca huan quilhuía: —Nehua otimitzpanahui huan tiquitohua ocachi ti chichicahua. —Nehuatl amo iqui niccahuaz!	Sigúeme. ~~~ Saltó el león, y el grillo colgóse de su cola y cuando dio el brinco [el grillo] cayó más adelante y le dijo: —¡Yo te pasé! ~~~ Y dices que eres más fuerte. —¡Eso no lo dejaré así!
Tiquittazque occepa ica totlacahuan! —Cualica!	Veremos de nuevo con nuestra gente. —¡Está bueno!
Quen tehua ticnequiz.	Como tú quieras.
Oncan tecuicuica oquinotz cente yoyoliton, cuatlayacatl, chilpan.	Entonces el grillo llamó a todos los mosquitos, abejas y avispas coloradas.
Oncan oquinamiquito cente aaconton huan cente mimiahuatl; no iqui oquinamiquito cente xixicoton quilhuía: —Xinechnanamiqui.	Después a un moscardón, a una avispa, [y] también fue a ver a un abejorro [y a cada quien] le dijo: —¡Ayúdame!
Oncan hueyi miztli noiqui ye tlatlalhuía, oquinamiquito cente polo, cahauayo, cuacue; no oquinamiquito mazatl, oquinamiquito cente yepatl, ye quilhuía: —Xinechnanamiqui.	Mientras, el león empezó también a invitar [a otros animales]; fue a ver a un burro, a un caballo, a un buey; también fue a ver a un venado; fue a ver a un zorrillo y entonces le dijo: —Ayúdanos.
68Huan oquito yeyepatl: —Tlenon ticnequi ica timitznanamiquiz.	Y dijo el zorrillo: 69—¿En qué quieres que te ayude yo?
Oquito: Nicnequi totehuitique ica occequin yolcame.	Dijo: —Quiero que vayamos a combatir con los demás animales.
Huan oconitoaya: —Zan ica nehuatl tlen quinequizique, zan xinechcahualli.	Y le dijo: —Conmigo solo [basta] lo que quieran. ~~~ Déjamelo a mí.
Oquito hueyi miztli: —Oya cualica!, ica tehuatl amo nomotía.	Dijo el león: —¡Estoy bien!, contigo no tengo miedo.
Oncan ye oquitlatitlanili in tecuicuica: —Axcan ye ima tonamiquizque ixtlahuapa Ayohualco, huan ompa tía ticnequi totehuizque.	Ya entonces retó al grillo: —Llegó la hora de encontrarnos en el campo de Ayohualco; si quieres, allí combatiremos. —Allá se verá quién gana.
Ompa motaz aqui non tlaxixiliz.	Espérame allí con tu gente.
Ompa xinechchía ica mo tlacahuan. ~~~ Oncan hueyi miztli oya canin oquitlalhui ica itlacahuan.	Entonces el león se dirigió al lugar donde había estado con su gente.
Oacic. —Noca xitlacuacan.	Llegó. —Coman entretanto.
Onca tlacuaticate icuac oquicaque tecuicuica ye otzatzic, quimilhuía itlacahuan: —Ximehuaca, ye oecoc hueyi miztli aquin ica totehuizque.	Cuando estaban comiendo, de repente oyeron que el grillo llamó a su gente y les dijo: —Levántense, que ya llegó el león con quien vamos a combatir.
Ornen, quinamicti.	Se levantó y fiie a su encuentro.
Oncan hueyi miztli ye oquipehualti motehuía huan tecuicuica zan tentzicuintinemi.	Entonces el león empezó a tirar zarpazos y el grillo nada más brincaba de un lado a otro.
Imán ye ocia, oquito hueyi miztli: Axan ica totlacahuan ma totehuican, za tehuan amida tochihuilizque.	Cuando se cansó, dijo al león: —Ahora combatamos con nuestra gente, pues nosotros solos no nos haremos nada.
Oncan ohualmonamictaque motehuía huan yeyepatl hueca quimittatica huan ohuallaque nin yoyolcame nontlamini, opeque quimini.	Luego se encontraron [sus ejércitos] y entraron a combate y el zorrillo desde lejos los veía y llegaron los animalitos que pican con su aguijón y empezaron a picarles.
Imán otzatzic hueyi miztli oquitzatzili, yeyepatl, quilhuía: —Xihualehua, ye nechtlamiticate!	Entonces gritó el león, llamando al zorrillo y diciéndole: —¡Ven, que ya están acabando conmigo!
Oncan ye otzatzic yeyepatl: —Axcan notlacahuan, tiehue ticpalehuia!	Entonces gritó también el zorrillo a su gente: —¡Ahora, mi gente, vamos a defenderlo!
Ye quitlamiticate.	¡Ya están acabando con él!
Oncan oya yeyepatl ica itlacahuan ipan occequin; oncan ohualaque itlacahuan Tecuicuica ipan yeyepatl huan nochtin itlacahuan yeyepatl omocuepque, omocuitlapiletiquetzque imixtlan yoyolime huan hueliquimicxi.	Entonces el zorrillo se dirigió con su tropa sobre los otros y entonces se echaron todas las tropas del grillito sobre el zorrillo y todos los soldados del zorrillito se volvieron con la cola levantada, de espaldas a los animalitos, y se ventosearon con fuerza.
Oncan ohualaque nochtin yoyolime impan huan oquinmiminque huan hueyi miztli ica occequin ye oquintepayoloque quintehuía.	Entonces se echaron todos los insectos sobre ellos y los picaron y al león y los demás ya los habían atarantado de tanto picarles.
Oquito hueyi miztli: —Axan xinechcahua!	Entonces dijo el león:—¡Ahora déjame, ya perdí!
Ye onitlapolo!	¡Te compondré tu palacio!
Timitzyectlaliliz motecpancalco!	¡Amémonos ahora como Dios manda!
Totlazotlacan que teotl motlanahuatilía.	Díjole el grillito: —¡Compon mi palacio!
Oquito tecuicuica: —Xicyectlali notecpancalco.Hueyi miztli tlen oquichin oconan cuacuecuitlatl huan ocontlali: —Ye otiquittac, zan nenca ye otinechcocolti.	Lo que hizo el león fue coger una boñiga de res y ponerla. —Ya viste, inútil fue que me hicieras daño.
Axan mantotlazotlacan que teotl quimotlanahuatilia huan man tlami nochi quexquich oticpiaya ica ototehuitinemia.	Amémonos ahora como Dios manda y que termine todo cuanto teníamos por lo que andábamos riñendo.
[END OF DOCUMENT].	[END OF DOCUMENT].
[NEW_DOCUMENT: DOCid=6, lang=nah, DOCNAME=CAPIZCAYOTL HUAN CITLI ].	[NEW_DOCUMENT: DOCid=6, lang=spa, DOCNAME= LA ZORRA Y LA LIEBRE ].
CAPIZCAYOTL HUAN CITLI .	LA ZORRA Y LA LIEBRE .
Nin orne yoyolcame cecpa cepan oyataya citli ica capizcayotl, ica pan ixtlauatl.	Estos dos animalitos iban una vez juntos, la liebre y la zorra, por la llanura.
Imanon occecuizuetzía, amo otlaxoxoquehuaya ipan ixtlahuatl ayac acá opanoya nian ye ica, imanin ye omayanaya, quitohua capizcayotl citli: —Nehua ye nimayana. —Nehuatl noiqui ye nitechoca nocuitlaxcoluan, ye mayana, ye napizmiqui. —Ye ima titlacuazque amitla tlenon nahuactoque miltin. —Nehuatl coza napizmiqui; tía cualli nocamac acizquía nonacazuan niquincuazquía. —Nehuatl icuac nitlacuaznequi nicpachichina nocuitlapil, ica inon tlamati noyollixco. —Amo huey chiahua tiquixtilliz, nehuatl nian nocuitlapil amo huei nicpie tlenon nicpachichinaz?	Entonces había helado, no había [nada] verde en la llanura, ya nadie pasaba por allí, cuando, sintiendo hambre, le dijo la zorra a la liebre: —Yo ya tengo hambre. —A mí también ya me chillan las tripas, ya me muero de hambre. —Ya comeremos luego, pues no hay nada sembrado por los campos que nos rodean. ~~~ Yo ya me muero de hambre; si mi boca llegase a mis orejas me las comería. —Yo cuando quiero comer me chupo la cola, y con esto calmo a mi estómago. —¡No has de sacarle mucha grasa!, [Pero] yo que ni siquiera tengo una cola bastante larga, ¿cómo he de chupármela? ~~~ Y tampoco se me endereza: no puedo morderla.
Nian ahuel nicquetzomaz.	Yo ya me muero de hambre.
Nehuatl ye napizmiqui, nin teme niquimita que ce cente ayotli.	Hasta las piedras me parecen calabazas.
Axan yoniquilnamic ayotli, tlaxquita ichpoch xochicualnamacac ca totlac huitz cuicatz tlemach xochicualli, quillitl, atzanalquilitl, coz tlahuiaya; tía xitlanecui.	Y ahora que pienso en las calabazas, mira a esa moza que vende fruta y viene hacia donde estamos; trae quién sabe qué tanta [diversidad de] frutas, verduras [y] berros, [que] huelen mucho. ~~~ A ver, huele.
Open tlanecui capizcayotl: Mellac!	La Zorra empezó a oler [y exclamó]: —¡De veras!
Zan niquilnamiqui no camac nicmatti que atl, que ye nicuatica. —Tía xicaqui tlen nia timitzilhuiz, yonicnemilli quénin ticcuicuilizque tictlachtequillizque nin oihuaton iacachiquihuitl ica nochi tlencuicatz.	Nada más de pensarlo se me hace agua la boca imaginando que estoy comiendo [todo eso]. —Oye lo que voy a decirte: ya discurrí cómo hemos de hacer para quitarle [y] robarle a esa muchacha su canasto con todo lo que lleva.
Tehuatl ximomicateca, nehuatl nia notlatiz; zanque mitzitaz timictoc quitlaliz tlalpa chiquihuitl, icuac mitzquitzquiz imanon nicantehuaz xochicualchiquihuitl, nicantehuaz quename cuac cente xollopitli cuica cente animantzin. —Cuallica tlen otic nemilli!	Tú acuéstate fingiéndote muerta [mientras] yo voy a esconderme; luego que vea que estás muerta pondrá en el suelo su cesto [y] cuando vaya a echarte mano, entonces me llevaré el cesto de fruta, llevándomelo como se lleva el diablo un alma. —Está muy bien lo que has discurrido.
Huan tía nechquitzquiz huan nechmictiz melac?	[Pero] ¿y si tras echarme mano me mata de veras?
Nehuatl nimitzilhuía nicmoca itla nechhuicxitizque itic cente xoctli ihuan nechyechichihuazque. —Inon tehuatl timitzcahuillia, xiquita quénin ticchihuaz; nehuatl huei nicchihua que onicnemilli nicuicaz acachiquihuitl.	Yo debo decirte que tengo miedo de que vayan a echarme en una olla y a querer guisarme. —Eso allá tú, ve lo que haces; yo ya he hecho mucho con haber discurrido [cómo] llevarme la cesta.
Zazo quénin in icuac mitzquitzquiz ximotonhuitzo, mocamiquiz huan mitzcacahuaz.	Como quiera que sea, 33cuando te eche mano te sacudes y te revuelcas; [entonces] se espantará y te soltará.
32Que omotlatolmacaque iquion oquiz.	Conforme a lo que hablaron, así sucedió.
Zanque oquittaque cihuanton ye acitaya, omotecatihuez citli inepantla otli, oquicehui chichihuitl, ocantihuetz citli.	Tan pronto como vieron que se acercaba la muchacha, la liebre se tendió en medio del camino [y la muchacha] descansó en el suelo su cesto y cogió a la liebre.
Zan papaqui cihuanton noca, capizcayotl oqui icanica omotlatti oquicamacuiten ihuan oquictiquiz quename cente tlacuezalotl.	Mientras la muchacha estaba muy contenta, la zorra salió de su escondite, arrebató [el cesto] con la boca y escapó corriendo como relámpago.
Cihuanton zanque oquitac cihuaichtequi icanica oyaya ica ixochicualchiqui, otzicuinten icuitlapan; noca citli omotonhuitzten oquiztiquiz ihuan omocepancentlallito ica capizcayotl.	La muchacha, que vio a la ladrona irse con su cesta de fruta, echó a correr tras ella, mientras la Liebre se sacude, se revuelca, escapa corriendo y fue a reunirse con la zorra.
Citli otzicuinía, otzicuinía, ahuel ocacia capizcayotl.	La liebre corría [y] corría y no podía dar alcance a la zorra.
Citli oquilhuiaya capizcayotl: —Ximomana, ximomana.	La liebre le decía a la zorra: —¡Detente! ~~~ ¡Detente!
Capizcayotl oquitletlecalhuiaya.	La zorra iba echando chispas.
Oacique itic cuauhtlatli; omocehuique.	Llegadas bosque adentro, descansaron.
Ye ociaque; tzicuini animantzin tetecuinía.	Ya se habían cansado; su corazón saltaba dando de golpes.
Citli amo oquimicuaniaya ixtololohuan itic xochicualchiquihuitl.	La liebre no quitaba los ojos del cesto de fruta.
Capizcayotl yoquinemiliaya zan icecelton oquitlamiani nochi quillitl ica xochicualli.	La zorra estaba discurriendo [cómo había de hacer] para comerse ella sola las legumbres y la fruta.
Capizcayotl oquilhuiaya citli: —Ca timocitl otimocuep.	La zorra le decía a la liebre: —¡Qué voraz te has vuelto!
Ihuan nin citli, amo ixcuahuitl, no iqui itzintlan inacazhuan oquinemiliaya quénin quixtlamachtiz quename ce tzotzocatl.	Y la liebre, que no era nada tonta, pensaba debajo de sus orejas cómo hacer para enseñarle a no ser tan miserable.
Zan mochihua cochi, omotlali.	Haciéndose la dormida, se sentó.
Capizcayotl zanque oquitac ye ocochía citli, zan cualli ocan chiquihuitl; yocuicaya imán oizac otzatzic citli: —Canin ticuica inon? —Amo xicuallani, nia nictlaliz tlatlayecayan; tle amo tiquita tlehuacticate ipan tonnalli? —Oya cepan tiacan; ya nehuatl no iqui nechtlatitica tonnalli.	La zorra, en cuanto vio que dormía la liebre, cogió bien el cesto. ~~~ Ya se iba con él, cuando despertó la liebre y le gritó: —¿A dónde vas con eso? —No te enfades; voy a ponerlo a la sombra. ~~~ ¿No ves que se están asando al sol? —Entonces vámonos juntas; a mí también ya me está quemando el sol.
Oyaque.	Se fueron.
Oacito itenco achololli.	Llegaron a la orilla de un charco.
Open citli que nochipa ica icuicatl, inin icuac otlacuaya.	Volvió la liebre a su canción, que cuándo comían eso.
Capizcayotl zan otlahuel tlachiaya ica aquin ihuan ohuallaya. —Ye ticmatti que xixicuinaliztli tlatlacolli; tlaticnequi te cualli tinemiz ximotlayohui axan, huan moztla titlacuaz. —Amo nicpía tlen ica nicchihuaz. —Tlen nia timitzilhuiz [oquito citli] nehuatl nicuicaz chiquihuitl nochan, ihuan moztla timitzchía.	La zorra, encolerizada, nada más veía a su compañera. —Ya sabes tú que la gula es pecado; si quieres que te vaya bien [o vivir bien] ayuna ahora, y [ya] mañana comerás. —No tengo por qué hacerlo. —Lo que voy a decirte —dijo la liebre— es que me llevaré el cesto a mi casa y [ahí] te espero mañana.
Capizcayotl niman otzatzic: —Inon amo; quinchihualtía motlayohuizque cicitin capizcayome, amo.	Luego gritó la zorra:—Eso no; hacer ayunar las liebres a las zorras, nunca.
Amo neci canin otiquitac inon. —Tlen cualli timitzilhuiz tía tiquinacizquía mimichtin ipan inin achololli, tiyectlacuazquía ihuan nihuetzca tlen achtopa oticuaque.—Cuallica tlen oticnemilli [oconito Capizcayotl]; zan nenca nocuatotonilía huan amo nicnemilía quénin timichacizque.	No sé dónde has visto eso. —Lo que sé decirte es que si pudiéramos coger los peces en ese charco, comeríamos muy bien y me río de lo que comamos primero. —Está bien lo que has discurrido —le dijo la zorra—; pero en vano me caliento la cabeza, y no descubro cómo hemos de coger los peces.
Onca cehualaquiahuitl. —Que neci amo melac que cente capizcayotl cuacuapitzahuac amo quimatti quénin michaciz.	Ahí hay hielo. —Parece mentira que una zorra inteligente no sepa cómo se han de coger los peces.
Tiquitaz que nehuatl ica notlancochhuan ihuan noctihuan nictlapotin cente tlacoyoctli icanica ticaquiz mocuitlapil; mimichtin apizmictazque, zanque quitazque mocuitlapil quiquetzomazque, imanon tictilanaz ihuan ye ticpiezque mimichtin.	[Ya] tú verás cómo yo con mis dientes y mis uñas, voy a abrir un agujero por donde [podrás] meter tu cola; los peces han de estar muertos de hambre, así que en cuanto vean tu cola la morderán [y] entonces la estirarás [afuera] y [así] ya tendremos pescado.
Omotlali capizcayotl itenco achololli canin oyeya cehualaquahuitl.	Sentóse la zorra a orillas del charco en donde había hielo.
Ocaqui icuitlapil; quichiaya quinquixtiz mimichtin. —Nin mimichtin iihuiantin, amo tlaquetzoma, huan nehuatl ye nicecmiqui; oncan nechaciz ce cualli cocoliztli. —Tía ornan nontlachía tía ye omacique tlen omacizquía.	Metió su cola [y] esperó a sacar los peces. —Estos pescados son listos, no muerden y yo ya me muero de frío; [lo que] voy a coger aquí es una grave enfermedad. —A ver, veré si ya se cogió lo que había de cogerse.
Inon oconito in icuac oquitac capizcayotl ye ocecmiquía: —Xi mocuani ihuan occe tonnalli ticmatizque.	Esto dijo cuando vio que la zorra ya se moría de frío. —Quítate y [ya] otro día veremos.
Omopacho citli itlac chichiquihuitl, open tlacua, tlacua; open tzatzi occente: —Xi nechcahui tlen nohuaxca. —Xi nechcahua man nitlacua huan tía mocahua, timitzcahuiz.	Se arrimó la liebre junto al cesto y empezó a comer, a comer, [y] la otra empezó a gritar: —¡Déjame lo que me pertenece! —¡Déjame comer, y si [algo] queda, te lo guardaré.
Tlen omocan, ocanten chiquihuitl ocuicac ichan citli.	Con lo que quedó, cogió el cesto y se lo llevó a su casa la liebre.
Otemota ica ipan tlatlatelli, oquitletlecalhuilitaya: —Xía, xía capizcayotl, oticnequía noca timahuiltiz, achtopa nehuatl moca onimahuilti. —Xi hualla! cícitli; xi hualla!	Iba bajando por el cerrito y le decía burlona: —¡Anda, zorra; querías dejarme burlada [y] yo me burlé la primera de ti! —¡Ven, liebrecita, ven!
Xi nechquixtiqui canin nica huan timitzmacaz nochi tlen ticnechiitlanilliz! —Aquin mitzneltocatica!	¡Sácame de aquí y te daré todo lo que me pidas! —¡Quién ha de creerte!
Aquin achtopa iztlacati ayecmo occepa moneltoca.	A quien ha mentido una vez, ya otra no se le cree.
Ompa ocehualacuapitzmic capizcayotl.	Y ahí se murió de frío la zorra.
[END OF DOCUMENT].	[END OF DOCUMENT].
[NEW_DOCUMENT: DOCid=7, lang=nah, DOCNAME=CAPIZCAYOTL HUAN CITLI ].	[NEW_DOCUMENT: DOCid=7, lang=spa, DOCNAME= LA ZORRA Y LA LIEBRE ].
CAPIZCAYOTL HUAN CITLI .	LA ZORRA Y LA LIEBRE .
Nin orne yoyolcame cecpa cepan oyataya citli ica capizcayotl, ica pan ixtlauatl.	Estos dos animalitos iban una vez juntos, la liebre y la zorra, por la llanura.
Imanon occecuizuetzía, amo otlaxoxoquehuaya ipan ixtlahuatl ayac acá opanoya nian ye ica, imanin ye omayanaya, quitohua capizcayotl citli: —Nehua ye nimayana. —Nehuatl noiqui ye nitechoca nocuitlaxcoluan, ye mayana, ye napizmiqui. —Ye ima titlacuazque amitla tlenon nahuactoque miltin. —Nehuatl coza napizmiqui; tía cualli nocamac acizquía nonacazuan niquincuazquía. —Nehuatl icuac nitlacuaznequi nicpachichina nocuitlapil, ica inon tlamati noyollixco. —Amo huey chiahua tiquixtilliz, nehuatl nian nocuitlapil amo huei nicpie tlenon nicpachichinaz?	Entonces había helado, no había [nada] verde en la llanura, ya nadie pasaba por allí, cuando, sintiendo hambre, le dijo la zorra a la liebre: —Yo ya tengo hambre. —A mí también ya me chillan las tripas, ya me muero de hambre. —Ya comeremos luego, pues no hay nada sembrado por los campos que nos rodean. ~~~ Yo ya me muero de hambre; si mi boca llegase a mis orejas me las comería. —Yo cuando quiero comer me chupo la cola, y con esto calmo a mi estómago. —¡No has de sacarle mucha grasa!, [Pero] yo que ni siquiera tengo una cola bastante larga, ¿cómo he de chupármela? ~~~ Y tampoco se me endereza: no puedo morderla.
Nian ahuel nicquetzomaz.	Yo ya me muero de hambre.
Nehuatl ye napizmiqui, nin teme niquimita que ce cente ayotli.	Hasta las piedras me parecen calabazas.
Axan yoniquilnamic ayotli, tlaxquita ichpoch xochicualnamacac ca totlac huitz cuicatz tlemach xochicualli, quillitl, atzanalquilitl, coz tlahuiaya; tía xitlanecui.	Y ahora que pienso en las calabazas, mira a esa moza que vende fruta y viene hacia donde estamos; trae quién sabe qué tanta [diversidad de] frutas, verduras [y] berros, [que] huelen mucho. ~~~ A ver, huele.
Open tlanecui capizcayotl: Mellac!	La Zorra empezó a oler [y exclamó]: —¡De veras!
Zan niquilnamiqui no camac nicmatti que atl, que ye nicuatica. —Tía xicaqui tlen nia timitzilhuiz, yonicnemilli quénin ticcuicuilizque tictlachtequillizque nin oihuaton iacachiquihuitl ica nochi tlencuicatz.	Nada más de pensarlo se me hace agua la boca imaginando que estoy comiendo [todo eso]. —Oye lo que voy a decirte: ya discurrí cómo hemos de hacer para quitarle [y] robarle a esa muchacha su canasto con todo lo que lleva.
Tehuatl ximomicateca, nehuatl nia notlatiz; zanque mitzitaz timictoc quitlaliz tlalpa chiquihuitl, icuac mitzquitzquiz imanon nicantehuaz xochicualchiquihuitl, nicantehuaz quename cuac cente xollopitli cuica cente animantzin. —Cuallica tlen otic nemilli!	Tú acuéstate fingiéndote muerta [mientras] yo voy a esconderme; luego que vea que estás muerta pondrá en el suelo su cesto [y] cuando vaya a echarte mano, entonces me llevaré el cesto de fruta, llevándomelo como se lleva el diablo un alma. —Está muy bien lo que has discurrido.
Huan tía nechquitzquiz huan nechmictiz melac?	[Pero] ¿y si tras echarme mano me mata de veras?
Nehuatl nimitzilhuía nicmoca itla nechhuicxitizque itic cente xoctli ihuan nechyechichihuazque. —Inon tehuatl timitzcahuillia, xiquita quénin ticchihuaz; nehuatl huei nicchihua que onicnemilli nicuicaz acachiquihuitl.	Yo debo decirte que tengo miedo de que vayan a echarme en una olla y a querer guisarme. —Eso allá tú, ve lo que haces; yo ya he hecho mucho con haber discurrido [cómo] llevarme la cesta.
Zazo quénin in icuac mitzquitzquiz ximotonhuitzo, mocamiquiz huan mitzcacahuaz.	Como quiera que sea, 33cuando te eche mano te sacudes y te revuelcas; [entonces] se espantará y te soltará.
32Que omotlatolmacaque iquion oquiz.	Conforme a lo que hablaron, así sucedió.
Zanque oquittaque cihuanton ye acitaya, omotecatihuez citli inepantla otli, oquicehui chichihuitl, ocantihuetz citli.	Tan pronto como vieron que se acercaba la muchacha, la liebre se tendió en medio del camino [y la muchacha] descansó en el suelo su cesto y cogió a la liebre.
Zan papaqui cihuanton noca, capizcayotl oqui icanica omotlatti oquicamacuiten ihuan oquictiquiz quename cente tlacuezalotl.	Mientras la muchacha estaba muy contenta, la zorra salió de su escondite, arrebató [el cesto] con la boca y escapó corriendo como relámpago.
Cihuanton zanque oquitac cihuaichtequi icanica oyaya ica ixochicualchiqui, otzicuinten icuitlapan; noca citli omotonhuitzten oquiztiquiz ihuan omocepancentlallito ica capizcayotl.	La muchacha, que vio a la ladrona irse con su cesta de fruta, echó a correr tras ella, mientras la Liebre se sacude, se revuelca, escapa corriendo y fue a reunirse con la zorra.
Citli otzicuinía, otzicuinía, ahuel ocacia capizcayotl.	La liebre corría [y] corría y no podía dar alcance a la zorra.
Citli oquilhuiaya capizcayotl: —Ximomana, ximomana.	La liebre le decía a la zorra: —¡Detente! ~~~ ¡Detente!
Capizcayotl oquitletlecalhuiaya.	La zorra iba echando chispas.
Oacique itic cuauhtlatli; omocehuique.	Llegadas bosque adentro, descansaron.
Ye ociaque; tzicuini animantzin tetecuinía.	Ya se habían cansado; su corazón saltaba dando de golpes.
Citli amo oquimicuaniaya ixtololohuan itic xochicualchiquihuitl.	La liebre no quitaba los ojos del cesto de fruta.
Capizcayotl yoquinemiliaya zan icecelton oquitlamiani nochi quillitl ica xochicualli.	La zorra estaba discurriendo [cómo había de hacer] para comerse ella sola las legumbres y la fruta.
Capizcayotl oquilhuiaya citli: —Ca timocitl otimocuep.	La zorra le decía a la liebre: —¡Qué voraz te has vuelto!
Ihuan nin citli, amo ixcuahuitl, no iqui itzintlan inacazhuan oquinemiliaya quénin quixtlamachtiz quename ce tzotzocatl.	Y la liebre, que no era nada tonta, pensaba debajo de sus orejas cómo hacer para enseñarle a no ser tan miserable.
Zan mochihua cochi, omotlali.	Haciéndose la dormida, se sentó.
Capizcayotl zanque oquitac ye ocochía citli, zan cualli ocan chiquihuitl; yocuicaya imán oizac otzatzic citli: —Canin ticuica inon? —Amo xicuallani, nia nictlaliz tlatlayecayan; tle amo tiquita tlehuacticate ipan tonnalli? —Oya cepan tiacan; ya nehuatl no iqui nechtlatitica tonnalli.	La zorra, en cuanto vio que dormía la liebre, cogió bien el cesto. ~~~ Ya se iba con él, cuando despertó la liebre y le gritó: —¿A dónde vas con eso? —No te enfades; voy a ponerlo a la sombra. ~~~ ¿No ves que se están asando al sol? —Entonces vámonos juntas; a mí también ya me está quemando el sol.
Oyaque.	Se fueron.
Oacito itenco achololli.	Llegaron a la orilla de un charco.
Open citli que nochipa ica icuicatl, inin icuac otlacuaya.	Volvió la liebre a su canción, que cuándo comían eso.
Capizcayotl zan otlahuel tlachiaya ica aquin ihuan ohuallaya. —Ye ticmatti que xixicuinaliztli tlatlacolli; tlaticnequi te cualli tinemiz ximotlayohui axan, huan moztla titlacuaz. —Amo nicpía tlen ica nicchihuaz. —Tlen nia timitzilhuiz [oquito citli] nehuatl nicuicaz chiquihuitl nochan, ihuan moztla timitzchía.	La zorra, encolerizada, nada más veía a su compañera. —Ya sabes tú que la gula es pecado; si quieres que te vaya bien [o vivir bien] ayuna ahora, y [ya] mañana comerás. —No tengo por qué hacerlo. —Lo que voy a decirte —dijo la liebre— es que me llevaré el cesto a mi casa y [ahí] te espero mañana.
Capizcayotl niman otzatzic: —Inon amo; quinchihualtía motlayohuizque cicitin capizcayome, amo.	Luego gritó la zorra:—Eso no; hacer ayunar las liebres a las zorras, nunca.
Amo neci canin otiquitac inon. —Tlen cualli timitzilhuiz tía tiquinacizquía mimichtin ipan inin achololli, tiyectlacuazquía ihuan nihuetzca tlen achtopa oticuaque.—Cuallica tlen oticnemilli [oconito Capizcayotl]; zan nenca nocuatotonilía huan amo nicnemilía quénin timichacizque.	No sé dónde has visto eso. —Lo que sé decirte es que si pudiéramos coger los peces en ese charco, comeríamos muy bien y me río de lo que comamos primero. —Está bien lo que has discurrido —le dijo la zorra—; pero en vano me caliento la cabeza, y no descubro cómo hemos de coger los peces.
Onca cehualaquiahuitl. —Que neci amo melac que cente capizcayotl cuacuapitzahuac amo quimatti quénin michaciz.	Ahí hay hielo. —Parece mentira que una zorra inteligente no sepa cómo se han de coger los peces.
Tiquitaz que nehuatl ica notlancochhuan ihuan noctihuan nictlapotin cente tlacoyoctli icanica ticaquiz mocuitlapil; mimichtin apizmictazque, zanque quitazque mocuitlapil quiquetzomazque, imanon tictilanaz ihuan ye ticpiezque mimichtin.	[Ya] tú verás cómo yo con mis dientes y mis uñas, voy a abrir un agujero por donde [podrás] meter tu cola; los peces han de estar muertos de hambre, así que en cuanto vean tu cola la morderán [y] entonces la estirarás [afuera] y [así] ya tendremos pescado.
Omotlali capizcayotl itenco achololli canin oyeya cehualaquahuitl.	Sentóse la zorra a orillas del charco en donde había hielo.
Ocaqui icuitlapil; quichiaya quinquixtiz mimichtin. —Nin mimichtin iihuiantin, amo tlaquetzoma, huan nehuatl ye nicecmiqui; oncan nechaciz ce cualli cocoliztli. —Tía ornan nontlachía tía ye omacique tlen omacizquía.	Metió su cola [y] esperó a sacar los peces. —Estos pescados son listos, no muerden y yo ya me muero de frío; [lo que] voy a coger aquí es una grave enfermedad. —A ver, veré si ya se cogió lo que había de cogerse.
Inon oconito in icuac oquitac capizcayotl ye ocecmiquía: —Xi mocuani ihuan occe tonnalli ticmatizque.	Esto dijo cuando vio que la zorra ya se moría de frío. —Quítate y [ya] otro día veremos.
Omopacho citli itlac chichiquihuitl, open tlacua, tlacua; open tzatzi occente: —Xi nechcahui tlen nohuaxca. —Xi nechcahua man nitlacua huan tía mocahua, timitzcahuiz.	Se arrimó la liebre junto al cesto y empezó a comer, a comer, [y] la otra empezó a gritar: —¡Déjame lo que me pertenece! —¡Déjame comer, y si [algo] queda, te lo guardaré.
Tlen omocan, ocanten chiquihuitl ocuicac ichan citli.	Con lo que quedó, cogió el cesto y se lo llevó a su casa la liebre.
Otemota ica ipan tlatlatelli, oquitletlecalhuilitaya: —Xía, xía capizcayotl, oticnequía noca timahuiltiz, achtopa nehuatl moca onimahuilti. —Xi hualla! cícitli; xi hualla!	Iba bajando por el cerrito y le decía burlona: —¡Anda, zorra; querías dejarme burlada [y] yo me burlé la primera de ti! —¡Ven, liebrecita, ven!
Xi nechquixtiqui canin nica huan timitzmacaz nochi tlen ticnechiitlanilliz! —Aquin mitzneltocatica!	¡Sácame de aquí y te daré todo lo que me pidas! —¡Quién ha de creerte!
Aquin achtopa iztlacati ayecmo occepa moneltoca.	A quien ha mentido una vez, ya otra no se le cree.
Ompa ocehualacuapitzmic capizcayotl.	Y ahí se murió de frío la zorra.
[END OF DOCUMENT].	[END OF DOCUMENT].
[NEW_DOCUMENT: DOCid=8, lang=nah, DOCNAME=COCOYOTL HUAN YEYEPATL ].	[NEW_DOCUMENT: DOCid=8, lang=spa, DOCNAME= EL COYOTITO Y EL ZORRILLO ].
COCOYOTL HUAN YEYEPATL .	EL COYOTITO Y EL ZORRILLO .
Cocoyotl ochantia itic itlacoyotl ipan cente tlatlatelli huan ce tonalli oquititla aquin oquitlacualzaquiliaya, quilhuía: —Axan tehua xihuía xictemoti tlen ticuazque noca nehuatl nicochi, ye ticmati nochi in yohualli amo onicoch, oc oniquimpipiaya pióme ipan cente piocalli huan amitla onichin, huan axan ye nicochmiqui.	El coyotito habitaba en su agujero en una loma, y un día le ordenó al que le traía de comer: —Ahora tú anda a buscar lo que hemos de comer mientras yo duermo. ~~~ Ya sabes que en toda la noche no dormí; estuve acechando a los pollos en un gallinero y no logré hacer nada, y ahora estoy muerto de sueño.
Oncan oquiz occente nelli oquitemoto tlen quicuazque; oya, noca occente cochcuacualaca.	Entonces salió el otro para ir a buscar algo de comer; se fue y, mientras, el otro se quedó roncando.
Oncan imán ye oízac ye tlaca huan occente amo neci, quitohua: —Ye tlenon huelliz ipan ye omochin? ~~~ Amo huitz.	Luego despertó ya muy tarde y como el otro no aparecía, exclamó: —¿Qué le habrá sucedido, que no viene?
Hueli nitlatzihui niquizaz.	Siento mucha pereza para salir.
Axan, quenin nicchihuaz?	Ahora, ¿qué haré?
Man notlacualtemoliti.	Iré a buscar mi comida.
Tle nechcocoa nocxihuan, ahuel niaz?	¿Acaso me duelen los pies para que no pueda yo ir?
Oquiz motlacualtemolito, huan oya nenemi, nenemi, huan oacito itic cente ohuacuatlalli huan oquinamiquito cente yeyepatl huan quitlatlanía cocoyotl: —Ya! canin tia?	Salió a buscar su alimento y anduvo, anduvo, y llegó a un cañaveral de maíz; allí encontróse con un zorrillo y le preguntó el coyotito: —¡Ea! ~~~ ¿A dónde vas?
Nehuatl onotlacualtemolico.	Yo vengo en busca de mi comida.
Tehuatl, canin no ye tia? —Nehuatl noiqui notlacualtemolico.	¿Y tú a dónde vas? —Yo también vengo en busca de mi comida.
Axan ye otonamiquico nican; tía tualtopazahuacan tía ticnequi tualtzicuinican.	Ahora ya nos encontramos aquí; apostaremos una carrera, si quieres correremos.
Nican ximomana ipan nin cuemitl huan zan tocepan tiquizazque icuac yexpa nitzatziz, cepan titzicuinizqie. —Ximochía, nia timitzilhuiz, huan tle zan nenca topapazahuazque?	Colócate en ese surco y juntos saldremos corriendo, y cuando yo grite tres veces, juntos echaremos a correr. —Espera. ~~~ Voy a decirte una cosa. ~~~ ¿Vamos a apostar la carrera de balde? ~~~ ¡Ea!
Ya, tle amitla nictlaniz?	¿Qué no voy a ganar nada?
Huan tía nococoltiz, tle zan nenca?	¿Y si me lastimo, será de balde?
Tía ticnequi tictlalizque dan nia nocuilitin, tía ye nitlapolohua timitzmacaz tlen notlacual, huan tía timitztlanilía tinechmacaz tlen tía titlacuaz. ~~~ Zazo quenin ticnequiz, den tehua tiquitoz yehua inon nicchihuaz. —Cuallica.	Si quieres, apostemos lo que voy a buscar; si acaso pierdo, te daré lo que debía ser mi comida, y si tú pierdes, me darás lo que ibas a comer. —Como tú quieras; lo que digas, eso haré. —Está bien.
Ce, orne, yeyi!, Coyotl open tzicuini, tzicuini, huan yeyepatl zan canepa omotlalhuilan omotlaltocac itic cuemitl.	¡Uno, dos, tres!, El coyote echó a correr, a correr, y el zorrillo nada más se arrastró por allí cerca y se metió a su agujero.
Huan coyotl amo oquima tía tía occente yeyepatl oyeya itzoncuac mili zan hueca otlacactaya huan icuac oquizato coyote ye ompon oyehuataya non occente yeyepatl huan oquilhui coyotl: —Tía tiehue occepa!	El coyote no sabía que otro zorrillo se encontraba al principio de la sementera y que de lejos lo estaba oyendo; así que cuando partió el coyote, ya estaba allí sentado el otro zorrillo, y le dijo el coyote: ¡Vamos otra vez!
Quen yez otinechxixili?	¿Cómo es que has ganado?
Tle ocachi cualli titzicuini que nehuatl?	¿Puedes correr mejor que yo?
	¡Veamos otra vez! 77Entonces de nuevo echaron a correr y otra vez ya estaba allí esperándolo el zorrillo, que le dijo: —Ya viste cómo te pasé.
Tía occepa tiualittacan.	Ahora dame lo que dijiste. —¡Ea!
76Oncan occepa omocepan man que oquizquetzicuini huan yeyepatl occepa ye ompon oyeya ye oquichiaya huan quilhuía: —Yotiquittac que zace otimitzpanahui.	Si tanto quieres que te regale lo que dije, espera a que yo vaya a buscarlo, y cuando volvamos a encontrarnos aquí, te lo daré. —¡No!
Axan xinechmaca tlen oticonito. —Ya tía ticnequi huei timitztlacoliz tlen otimitzilhui xinechchía oc manictemoti huan cuac occepa tonamiquizque, nican, timitzmacaz. —Amo!	¡Si quedamos en que aquí me lo darías! —Pero si ahora no tengo nada. —Si quedamos en que aquí me lo darías; ¿acaso eres una criatura?
Tía otiquitoque nican tinechmacaz. —Auh axan amitla nicpía. —Tía otimocan nican tinechmacaz, tle ticoconetl?	Tú ya eres muy grande, tienes juicio ¡y me haces esto!
Tehua ye ocachi tihueyi huan titlacamalactic huan iquion tinechchihualtia!	¡Eso déjalo para las mujeres!
Inon xiquincahuili zohuame!	¡No es propio de ti, que eres un hombre! —¡Ea!
Amo tehuatl, titlacatl. —Ya, tle amo tinechcaqui coyotl? —Ye otimitzilhui nican xinechchía. —Oya xicantetziti; noca nehuatl nican nictemoa cente nenextecuilli nicuaz.	¿Acaso no me oyes, coyote? —Ya te dije que me esperes aquí. —Entonces ve a traerlo. ~~~ Entretanto yo buscaré por aquí algunos gusanitos que comer.
Tía tinech anilitin, xitzicuini.	Si has de traerme algo, corre por ello.
Oquiztiquiz coyotl, zan mocuitlapil otequetzti, huehuetzca.	Echó a correr el coyote con la cola parada y se fue riendo.
Yoquic occepa omocuep huan axan ye quichixtica yeyepatl.	Ya no volvió nunca y hoy todavía lo está esperando el zorrillito.
[END OF DOCUMENT].	[END OF DOCUMENT].
[NEW_DOCUMENT: DOCid=9, lang=nah, DOCNAME=CHICHIHUEHUE HUAN COYOTL ].	[NEW_DOCUMENT: DOCid=9, lang=spa, DOCNAME= EL PERRO VIEJO Y EL COYOTE ].
CHICHIHUEHUE HUAN COYOTL .	EL PERRO VIEJO Y EL COYOTE .
Ce chichi huehue ayocmo oquitlazotlaya niteco, ayocmo xictlamaca inin chichi, ye tetlayelti, ye huehue.	[Éste era] un perro viejo [al cual] ya no quería su dueño; ya no [se] le daba [de comer] a aquel perro [que] ya apestaba [y] era viejo.
Otlatlacoya, ayocmo quitlamaca.	[El perro] estaba triste [porque] ya no le daban de comer.
Oquinamic coyotl, quilhuía: —Tleca tlitlacoya? —Amo nitlaqua jbor in ye nihuehue.	Se encontró con el Coyote, [que] le dice: —¿Por qué estás triste? —No tengo que comer porque ya estoy viejo.
Axan ninenemi canican, ayocmo nechtlazotla noteco.	Ahora ando por aquí [vagando]; mi amo ya no me quiere.
Quitohua coyotl: —Xinechmaca cente huexolotl.	Le dijo el coyote: —Dame un pavo.
Niaz ompa teotlac niquixtitin ihuan tehua tiquizaz huan tihuahualoz huan timitzcahuilitehuaz; huan tiquitaz niman mitztlamacazque.	Esta noche iré a buscarlo y tú saldrás a ladrarme y te lo abandonaré; y entonces verás que sí te darán de comer.
Ihuan oya teotlac, huan oquiquixtili huexolotl, huan chichi huehue oquiz tlahuahuatihui: —Hua, hua, hua!	Y llegó la noche y [el coyote] fue a sacar un pavo y el perro viejo salió a ladrarle: —¡Gua, gua, gua!
Oquiquixtili huexolotl in coyotl, ihuan yahui ni teco: —Ay, nochichi huehue!	[El perro] le quitó el pavo al coyote y [entonces] salió su amo: —¡Ay, mi perro viejo!
Yoquiquixtili huexolotl in coyotl!	¡Ya le quitó el pavo al coyote!
Ay nochichi huehue!	¡Ay, mi perro viejo!
Axan xicmacacan cente tlaxcalli titilactic!	¡Ahora que le den de comer una tortilla gruesa!
Ay nochichi huehue!, 86 [END OF DOCUMENT].	¡Ay, mi perro viejo! 87 [END OF DOCUMENT].
[NEW_DOCUMENT: DOCid=10, lang=nah, DOCNAME=XOCHICUALTEQUITCA PILTONTLI ].	[NEW_DOCUMENT: DOCid=10, lang=spa, DOCNAME= EL NIÑO HORTICULTOR ].
XOCHICUALTEQUITCA PILTONTLI .	EL NIÑO HORTICULTOR .
Nelli motohua que onemía cente nantli oquipix iconen imán otlacat huele ochocaya, amo manel oquinequía chichiz, zan onempehuaya choca open inana quitlatemolía canin oquicocouaya huan amitla oquinextilli.	Se cuenta que ésta era una señora que tuvo un hijo. ~~~ Cuando nació lloraba mucho, ni siquiera quería mamar, sólo estaba llorando. ~~~ Su mamá empezó a registrarlo buscando qué podía dolerle y no encontró nada.
	Entonces ordenó su mamá que se le preparase un atole blanco.
Imán otlatitla nantli man quichichihuilican iztac atolli, niman oquichichihuilitetzque in tlen otlatequimacoc nampa noca quichichihuilía tlen quiz piltzintli nican quiyolalía huelle choca ahuel atlamataya zan que ohuccic in iztacatolli niman otzicuinten tlatequipano ocuiquilitihuetz tlen oquizquía in pipiltontli opeque quitlanenequiltía amo oquinequía tlaíz, aquitohuaya huelliz quinequiz motzopeloltiz, man motzopelolti, oquitzopeloltique; nian iquión amo oquinec quiz.	En seguida se lo hicieron como había ordenado. ~~~ Mientras preparaban lo que había de tomar el niño para contentarlo, pues lloraba mucho, la señora madre estaba inquieta. ~~~ Tan pronto como se coció el atole blanco, en seguida corrió la criada a llevárselo para que lo tomase el niño.
Quitohua tlatequipano: Man nic chichihuilliti yeloatolli, oquichichihuilli, no iqui amo oquinec quiz.	Empezaron con mimos para que lo tomase y no quiso; pensaron que quería que se lo endulzaran. ~~~ "Que se le endulce" [ordenaron], y se lo endulzaron. ~~~ Mas tampoco quiso tomarlo.
	Dijo la criada: —Iré a hacerle atole de elote.
Huan zan que nochipa ocachi ochocaya, ye omocamiquía, tlen za ye ya miquiz, in piltzintli, nantli niman oquititla tlatequipano quilhuía: —Xitenotzati in tepati man quittaquí in piltzintli huelle choca huan amo quinequi tlacuaz.	Se lo preparó y tampoco quiso tomarlo. ~~~ Y como cada vez lloraba más, temió [la madre] que pudiese morir el niño, [y] ordenó a la criada: —Anda a llamar a la curandera, que venga a ver al niño que llora tanto y no quiere comer.
Onquiz cihuatl ontenotzáto tepati man quitaqui noce man quitad in piltzintli tlen nozo quipía huele choca: Nin cihuatl oacito ichan tepati, otetlapalo ocalac ichan tepati.	Salió la mujer en busca de la curandera para que fuese a ver o a curar al niño, que quién sabe qué es lo que tiene que llora tanto. ~~~ Llegó la mujer a casa de la curandera, saludó, entró y dijo: —Ya me cansé.
Nin cihuatl quitohua: —Ye onicía, huele hueca tichanti. —Canin timochandlía? —Nichanti techan cente cihuapa tetoca cihua cuetzpalli, onechhual titlanque nelli mitzmotlatlatillia xicmopatilliti te coconen mococoa.	Habitamos muy lejos de aquí. —¿En dónde habita usted? —Vivo en casa de una señora que se llama doña lagartija y me ordenó que viniese a suplicarle a usted que vaya a curar a su hijo que está enfermo.
Tía timuicaz, nelli niman. —Xinechmochilli, ocepan tiazque, nia nictlalliz tlen notech monequiz.	Si ha de ir usted, que sea desde luego. ~~~ Espéreme usted. ~~~ Iremos juntas. ~~~ Nada más arreglo lo necesario.
Oquitlalli itic ichiqui in xipatli; oquizque huan oyaque.	Puso en su cesto todas las hierbas medicinales y salieron y se fueron.
Ocalaquito ichan cihua cuetzpalli huan niman oquitzdhuetz in cococoxqui quenin oyeya; tepati oquintlatlani: —Tlenon anquitia? —Amitla quinequi quiz, zan nen pehua choca.	Llegaron a la casa de la señora lagartija y en cuanto la curandera vio cómo estaba el niño enfermo, preguntóles: —¿Qué le dan a tomar? 99—No quiere tomar nada; sólo está llorando.
98Oquimatoquilli in iyolixco zan cemi ohuactaya, niman oquimilhui: —Xicualicacan tepitzin octli.	Le palpó la boca al estómago; lo tenía muy enjuto, y entonces dijo: —Traigan un poquito de pulque.
Open quitia, octli huan niman otlamata.	[Y en cuanto] empezó a dárselo, se puso contento [el niño].
Achtopa oquitilli ipan iyolixco, oquipiaya cuicuiltic ica iyezo cente metí; oquimilhui: —Tía ximotilli, nonantzin, inin metí itech iyolixco cuilitica, inin quitoz nequi mohuepahuaz ica octli.	Antes había visto que tenía pintado sobre su estómago, con sangre, un maguey [y] dijo: —Mire usted, señora, este maguey que aparece pintado en su estómago quiere decir que deberá criarse con pulque.
Noca muepahua, xiquitican tlen ye anquicaque ye amechilhui.	Mientras crece denle a tomar lo que les he dicho; cuando llegue [a la edad de] siete años, ya le cambiaremos de alimento.
Inin in icuac aciz chicóme xihuitl, ye occe tlacualli mopatilliz.	Entretanto vamos a curarlo.
Noca axan tiehue ticpatizque.	Empezó a curarlo.
Open quipatia, oquiezpachichin pan iyolixco; oquipopochhui ica teyatli; zoyatl, copalli huan tlemach occequi patli; oquialahuilli inepantla iyolixco iezo tequihua.	Chupó la sangre sobre el estómago, lo sahumó con hipérico, palma, incienso y otras muchas hierbas medicinales; le untó sobre el estómago sangre de gallo, que con esto se borraría el maguey que tenía pintado el niño; lo sahumó [luego] y así ya no [volvería] a llorar.
Nelli ica inon popolihuiz metí cuiltica ipan piltzintli, oquipopochhui huan iquion ayecmo chocaz.	Desde que lo curó no volvió a llorar [ya], siempre estaba tranquilo; una vez que le daban pulque ya no había que darle otra vez, se dormía y hasta otro día dábanle de beber.
Zan que oquipati, ayoquie ochocac; nochipa zan otlamataya, zan que oquía octli, ayecmo occecpa oquimacaya ocochmiquía huan quin moztlatica occepa oquitiaya.	[Cuando] cumplió siete años, de nuevo fue a verlo aquella curandera y tornó a sahumarlo con cedro, incienso e incienso blanco.
Ocaxilti in chicóme xihuitl, occepa oya zan ye yehuatl tepati, huan occepa oquipopochhui ica tlatzca, tecopalitl, capallitl iztac; zan que omocencan oquican opanoc tepitzin huan oncan occepa, oqui tlatemolli huan ica nohuían oqui nextilli ipan iacolhuehuepal, occepa que oquicuicuiloque miactin xochicualcocone, huan oquimilhui: —Nonantzin, tlaxmotilli tlenon onez miec xochicualcocone inin noiqui qutoznequi xochicualcuani yez; huan nican ipan ima yecantli quipía cente centli, ipan iopochma, tlaxmotilli, quipía cente ayomecatl ica cente aayotli; inin no iqui quitoznequi yez tequitqui in icuac ye huei yez.	Cuando terminó, dejó pasar un rato y luego registró [su cuerpo] otra vez, y sobre su espalda encontró pintadas muchas frutitas, y le dijo a su mamá: —Mire usted, señora, lo que aparece aquí; son muchas frutitas que indican que deberá mantenerse con fruta, y aquí, en la mano derecha, tiene una mazorca, y en la mano izquierda, vea usted, tiene una guía de calabaza con una calabacita, lo que quiere decir que será trabajador cuando sea grande.
Axan anmotlacualtilizque nochi yehuatl xochicualli, anmotequilitihui non mopacachihua atlaco, non quitequipanohua ehecame, que inon quinequi quicuaz.	Ahora denle por alimento fruta únicamente; vayan a cortar de la mejor en la barranca, donde pasan los aires; de ésa es de la que debe comer.
Huan iquion ica ocuepaque in pipiltzintli, ica xochicualli.	Y así fue como criaron a aquel niño con fruta.
Oncan quimilhuía tepati: —Axan nía nicpatiz.	Luego dijo la curandera: —Ahora voy a curarlo.
Oquipachichin inmamahuan huan pan yacolhuehuepal.	Le chupó en las manecitas y en la espalda.
Oc oquichix yei tonalli, oqui pozoni caxtillanxochiü ica cenpualxochitl, cuatlaxitzin, zan que nochi inin oqui pozoni ica tlatzcacuahuitl; oncan oquicahuato oc yei tonalli itic cente tepetlaoztotlatlaco huan oquimnde/atlatiliaya, yohualli tonalli, huan pan chicnahui tonalli, oquipapac ipan yacolhuehuepal ica inon auyaca atl ye oquitiochique ehecame.	Pasados tres días, hirvió rosa de Castilla, cempasúchil, té del monte; luego que hirvió todo esto con madera de cedro, dejólo durante tres días en una cueva de la barranca y le encendieron velas noche y día, y alos nueve días le lavó la espalda con aquella agua perfumada que habían bendecido los aires.
Zan que oquipapac pipiltzintli, man niquito ocalti, nin tepati huan iquion opopolli nochi inon xochicualcocone ocuicuilitaya ipan yacolhuehuepal, nochi opopolli. ~~~ Huan oquicuitiaya "xochicualtequitca piltontli".	En cuanto lavó a la criatura o, más bien dicho, la bañó la curandera, en seguida se borraron las frutitas que tenía pintadas en la espalda, todo desapareció, y [desde entonces] le llamaban "el niño horticultor".
Amo oyeya cente milli, nian cente calmilli amo oquipiani cente onoce ocachtin xochicualcuame, huan quitohua nochintin oquin tocac ica no huían xochicualcuame; nelli tlamo amo yezquíani nian cente xochicualcuahuitl.	No había ni un solo campo de labranza, ni un solo solar que no tuviese árboles frutales, y se dice que fue él quien los sembró dondequiera, que sin él no habría ningún árbol frutal.
Tlatiochica ehecatlacatl huan icanica oyaya opanoya, nochtin tlaca omopechtecaya.	Hombre bendito de los aires, por dondequiera que pasaba todos le hacían reverencia.
[END OF DOCUMENT].	[END OF DOCUMENT].
[NEW_DOCUMENT: DOCid=11, lang=nah, DOCNAME=TATAPACHICHI ].	[NEW_DOCUMENT: DOCid=11, lang=spa, DOCNAME= EL SALTAMONTES COLORADO ].
TATAPACHICHI .	EL SALTAMONTES COLORADO .
Tatapachichi oyeya pan milli omocehuitaya ihuan nacaztatapa ipan otentzicuin quilhuía: —Ha! ~~~ Pilalactli, nopan yotitentzicuin.	El saltamontes colorado estaba descansando en la sementera y el Saltamontes sordo cayó sobre él de un brinco, y dijo: —¡Ay, muchacho, brincaste encima de mí!
Huan onahuat: —Ya!	Contestó: —¡Ea!
Tle tiquitohua?	¿Qué dices?
Ye tihuehuentzin?	¿Ya eres viejo?
Quitohua: —Ye nihuehuentzin. —Tía melahuac ye tihuehuentzin, quezquipa yotiquitac no cuatopilitotilo1 huan no tlemoyototoco?2 Huan tehuatl, quezquipa yotiquitac? —Nehuatl chicocpa, huan tehuatl quimach titlacati huan niman ye tihue huentzin.	Y respondióle: —Ya soy viejo. —Si eres de veras viejo, di, ¿cuántas veces has visto la danza del bielgo y también el corretear de las chispas? —Y tú, ¿cuántas veces lo has visto? —Yo, siete veces, y tú acaso acabas de nacer y ya te dices viejo.
Otiquitac que yotimitztlan; amitla cualli tinechilhuía tlen timitztlatlanía.	Ya ves que te he ganado, nada puedes decir de lo que te pregunto.
Omonahuati nacaztatapa, opatlan huan oya.	Se despidió el saltamontes sordo, voló y se fue.
1 Baile con bordones de palo.	
2 El correr de las chispas: "buscapiés" 82 [END OF DOCUMENT].	83 [END OF DOCUMENT].
[NEW_DOCUMENT: DOCid=12, lang=nah, DOCNAME=MOTLACAMATI HUAN IYOLCAME ].	[NEW_DOCUMENT: DOCid=12, lang=spa, DOCNAME= EL HOMBRE RICO Y SUS ANIMALES ].
MOTLACAMATI HUAN IYOLCAME .	EL HOMBRE RICO Y SUS ANIMALES .
Inin achca oquinpiaya ichan cente mazad, cente oquichtentzo, cente cihuacuacue huan cente calnelo, huan ocachtin mach yolcame oquinpiaya ichan.	Éste era un rico que tenía en su casa un venado, un cabrito, una vaca y un cordero, y otros animales más que tenía en su casa.
Momoztla mochtin inin yolcame oquinhuicaya cente piltontli oquinzacacualtiaya ixtlahuapa, oquititlanía teachca; ipan ichan nochi oquipiaya, tlaolli, zacatl, zacacelic; nochi den itech omonequía; huan inyolcahuan amo oquinmacaya; tlen oquichihuaya, achtopa oquitominquixtiliaya, noca teyolcahuan ocuatetiaya, ye ocuatemiquía; icuac achtopa oquipix pan occe xitica amo itlamochin, nochi otlazotic; imán oquittac nin amocualli achca, ayocuel oquintlacualtiaya, nian ayecmo onca aquin oquinhuicani ixtlahuapa; tlen oquichin, oquitemo cente tlacatl.	A diario, un muchacho llevaba a pacer a estos animales al campo, lo enviaba su patrón, [aunque] en su casa tenía de todo: maíz, paja, forraje verde, todo lo que se necesitaba, [pero] a sus animales no se lo daba; lo que hacía primero era vender sus forrajes, mientras sus animales se enflaquecían; ya se morían de flacos, y en el primer año no se dio nada, que encareció todo, cuando vio aquel malvado rico que ya no podía darles de comer, ni tenía quién los llevara al campo, lo que hizo fue que buscó un hombre [y a] este hombre lo envió aquel rico para que abandonara aquellos cuatro animales, que los había apartado para comérselos. —Ya no pueden engordar; sólo he perdido inútilmente con ellos el dinero.
Nin tlacatl oquititla nin achca man quincahuati non nahui yolcame, oquinmocahui nelli quincuaz: —Ya ahuelli tomahui, zazan ye onicnenpolo tomin.	El hombre que había tomado a su servicio le dice: —¿A dónde habré de ir a dejarlos?
Quitohua tlacatl, non oquitlaquen, quilhuía: —Canin niquincahuatin?	¿A mi casa o a la iglesia? ~~~ A lo que contestó el rico: —¡No seas tonto!
Nochan onoce teopa?	¡No seas cabeza de piedra!
	¡Orejas de tepetate!, ¡Si todavía no te digo a dónde has de llevarlos!, ¿Acaso ya te lo dije? —No, mi amo, todavía no me dice usted a dónde he de llevarlos, a donde usted me lo ordene. —Sácalos luego y anda a dejármelos en el campo a estos cuatro animales; ya no quiero tenerlos aquí.
Onahuat achca: —Amo xi ixcauhuitl, amo xi ixcuatenmaz huehue, nacaztepetla; tía ayecmo timitzilhuía canin tiquinhuicaz.	El buen hombre los desató y fue a abandonarlos a la orilla del pueblo, por donde no hay nada que comer; [allí] los dejó y se regresó.
Tle ye otimitzilhui? —Amo noteachca, ayecmo tinechmolhuilía canin niquinhuicaz, canin xinechmolhuilli. —Niman xiquinquixti huan xinechmincahuiliti ixtlahuapa inin nahui yolcame; ayecmo nicnequi nican niquinpiaz.	El venado, el cabrito, la vaca y el cordero empezaron a platicar sentados en ruedo, discurriendo qué era lo que debían hacer para buscar el sustento. ~~~ Cuando todos parecían más tristes, exclamó el venado, que era el más listo: —¿Qué es lo que hay qué hacer? —dice a los otros animales.
In cualli tlacatl oquintonto huan oquincahuato itenco altepec, icanica amonca tlen quicuazque; oquincacan huan omocuep tlacatl.	Si ustedes quieren, miren: yo ya conozco aquí por dondequiera; si gustan, síganme y ya sabré a dónde llevarlos.
Mazatl, oquichtentzo, cihuacuacue huan calnelo, opeque mononotza, omoyahualoque quinemilia quenin quichihuazque, que nin motlacualtemolizque.	A esto contestaron todos: 45—Nos iremos todos juntos, buen venadito; lo único que te rogamos es que no nos vayas a abandonar y te perdamos y nos oscurezca.
Imán nochtin tlacoltlachía, onahuaten mazatl, ocachi iihuían: —Quenin monequi mochihuaz? —quimilhuia in occequin yolcame.	Tú sabes a dónde nos llevas. —Hermanos míos, no se amedrenten; yo respondo de ustedes.
Tía anquinequi, tlaxquitacan: nehuatl ye niixtlamati ica nohuían; tía aquinequi zan xinechtocacan huan nehuatl nicmati canica namechhuicaz.	Cuando empezó a oscurecer los llevó a una cueva. ~~~ Aquel día, o más bien dicho, aquella noche, allí durmieron.
44Onahuatque mochtin: —Man cepan tiacan.	Esa noche no salió, ya estaba muy cansado y durmió como una piedra.
Cualli mamazatl, tlen timitztlatlatia, ame titechcahuaz cana tomoixpolotin, huan topan tlatlayohuaz; tehuatl ye ticmati canica titechhuica. —Nocnihuan amo ximomotican, nehuatl amoca nitlatoz.	En la mañana temprano se levantó el venado y dijo a los que habían dormido con él: —Espérenme mientras voy a buscar por aquí algo qué comer; si encuentro, luego lo traeré.
Imán ye open tlatlayohua, oquinhuicac ipan cente tepetlaoztotl.	No iría muy lejos de su casa, cuando los demás animales oyeron que alguno, no sabían quién, venía corriendo.
Inon tonalli, man niquito inon yohualli, ompan ocochque.	Dijo el cordero: —Parece que es el venado el que viene corriendo, quién sabe qué le asustó.
Inon yohualli amo oquizaya, ociamictaya; ocochimic que cente tetl.	A lo que replicó el cabrito: —¿Qué quieres que le haya asustado? —¡Cómo no!
Zan ocuatzinco orne ten mazatl, quimilhuía non cepan ocochque: —Xinechchiacan nia nictemotin icanica titlacuatihue, tía niman nicnextía, niamechanaquin.	¿No ves que puede haberlo asustado algún león o algún tigre que quizá quería comérselo?, ¡No se sabe!
Amo huecapa onquiz itic ical, imán occequin yolcame oquicaque tlen nozo hual tzicuini; quitohua calnelo: —Neci yehuatl mazatl hual tzicuini.	[Entonces] dijo la vaca: —¡Ténganse quedos, cállense la boca!
Tlen nozo oquimoti. ~~~ Nahuati oquichtentzo: —Tlenon ticnequi quimotiz? —Quen amo, que tiquita hueliz itla huei tecuani oquimomoti, onoce itla ocelotl, hueliz oquicuazquia; amo machía.	¡No vaya a suceder que nos oiga el león y aquí se acabó el mundo!
Quimilhuía cihuacuacue: Xitlamatacan, qui ximocamatzacuacan, techoncaquiz huei miztli, inon xiquitocan ye tlaltzonco ticate.	Luego se sosegaron, ya ninguno se movió; entonces la vaca se asomó a la puerta de la cueva a ver quién venía.
Imán otlamataque, yocaca omoliniaya; imán cihuacuacue open mixtia caltenco tepetlaoztotl oquitani tlen ohualaya.	El cordero y el cabrito temblaban de miedo; y les dice la vaca: —¡Qué veo!, Viene escurriendo sangre el venado.
Calnelo huan oquichtentzo papatlaca mocamiqui; huan quimilhuía cihuacuacue: —Tlenon niquitta!	Asustados exclamaron los demás animales, el cordero y el cabrito: —¡A ver!
Ezchachapacatihuitz mazatl!	El otro también dijo: —¡A ver!
Omoca nahuatque occequin yolcame, calnelo huan oquichtentzo: —Ma niquitta!	En cuanto lo vieron salieron a todo correr yendo a ver en dónde había entrado, llegando asustados.
Occente noiqui quitohua: —Ma niquitta!	Ya no entró a la cueva sino que fue a acogerse a otra casa de tepetate.
Imán oquittaque, oquiquiztiquizque; oquitato canin ocalac, omacatzicuintaya!	Le preguntaron los animales amigos suyos: —¿Qué te ha sucedido, buen venadito? —Iba muy contento, bajando por allí, cuando me disparó un hombre.
Ayecmo ompa itic tepetlaoztotl ocalaquito, occecni tepetlacalli omotoctito; quitlatlanía iyolca icnihuan: —Tlenon mopan omochin, cualli mamazatl? —Zan nipapaqui nitemotoya nepa, in icuac onechmotlac cente tlacatl; hueliz oquinequía nechmacaz ipan nacolhuehuepal huan amo onechmacac; zan onechxixintiquiz itlac noquechcuayo.Cihuacuacue niman tlen oquichin, quemilhuía non ocome icnihuan: —Axan ticpatican!	Quizá quería acertarme en la espaldilla; no hizo blanco y nada más me pasó rozando [la bala] cerca del pescuezo.Lo que [entonces] hizo la vaca fue decir a sus dos hermanos: —Ahora vamos a curarlo.
Calnelo oquititla man oquicentlaliti aalactli, none quiquixtianoxihuitl; noca oquichtentzo oquititla man quicuiti atl huan michpatli.	Al cordero le envió a que fuese a juntar la [hierba llamada] babosilla y mostaza silvestre, mientras al cabrito le mandó que fuese a buscar agua y medicina del pez.
Nin cacalnelo ayecmo omocuep; huelliz icompa oquicua tecuani.	El corderito ya no volvió, quizá el lobo se lo comió.
Quichía, quichía, nian quin.	Lo estuvieron esperando, esperando, y nada.
Huan nican za quichía quipatizque mazatl; zan oquicuitlaxtocac canin oquimotlaque.	Lo esperaban para curar al venado, al que nada más había rozado la bala entre cuero y carne.
Que oquinemilli oquichtentzo, quitohua: —Man huía cihuacuacue man quitemoti cente tepati, man quipatiqui mazatl.	Como lo pensó el cabrito dijo: —Que vaya la vaca a buscar un médico que venga a curar al venado.
Oya oquitemoto, cente chichi huehue.	Fuese en busca de un perro viejo.
Oquinextito ica itic tonalocoyo huan niman quilhuiti: —Cualli chichichiton, tlenon taxtica? —Amitla, tlaxiquita.	Topó con él en el pinar y le dijo: —Buen perrito, ¿qué estás haciendo? —Nada, ya ves.
Ic oncan ocuacuahuico noachca huan onechhualicaque —quitohua chichiton—; huan tehuatl cualli cihuacuacue, tlenon tictemotinemi icanican? —Nia timitzilhuiz tlenon onechhualicac icanican. —Xiquito cualli cihuacuacue. —Niantimitzilhuiz; axan que moca oniquizaco, tehuatl timitztemotihuitz. —Tleca? —Ticpía cente cocoxqui huan nicnequi ticpatitin, timitztlatlatía. —Huan de hueliz cualli nicpatiz? —Quenamo!	Mi amo vino a cortar leña por aquí, y me trajo —dijo el perrito—; y tú, buena vaca, ¿qué andas buscando por aquí? —Voy a decirte qué fue lo que me hizo venir aquí. —Dilo, buena vaca. —Voy a decirte; ahora que he dado contigo, a ti es a quien vengo buscando. —¿Para qué? —Tenemos un enfermo y quiero que vayas a curarlo; yo te lo ruego. —¿Y acaso podré curarlo? —¡Cómo no!
Ocuicac cihuacuacue in chichihuehue; oacique canin tlapatizquía.	Se llevó la vaca al perro viejo; llegaron al lugar a donde iba a hacer la curación.
Open quipatía mazatl.	Empezó a curar al venado.
Achtopa oquicecentlalitaya ipan otli xipatli.	Antes, en el camino, habían juntado hierbas medicinales.
Cihuacuacue mocxianaya.	La vaca se apresuraba.
Chichiton open quipapalohua canin oquicocuaya mazatl; zan que ye oquipapalo, oquitlaliti xipatextli.	El perrito empezó a lamer la parte enferma al venado; una vez que la hubo lamido, le puso hierbas medicinales machacadas.
Amo huepa ocehuic.	No tardó mucho en aliviarse.
Noca oquichtentzo oconcuicuía tlen quicuazque; huan iquion icochantia pan cuautlatli inin yoyolcame.	Entretanto el cabrito iba a buscar lo necesario para que comiesen, y así vivían en el bosque aquellos animalitos.
Imán itla oquicaquía inintin omocamiquía.	Luego que oían algún ruido se alarmaban.
Moztlatica oquicaque otzatzic cente huei miztli; imán omocamic oquichtentzo, chichiton huan cihuacuacue.	Al día siguiente oyeron rugir un león y en seguida se asustaron el cabrito, el perrito y la vaca.
Quimilhuía mazatl: —Tía xittacan, tía itla ye topanhuitz amo ximomotican: cihuacuacue quinpia icuacuahuan tlen ica mopalehuiz; amehuan nia mechilhuiz: tehuatl, oquichtentzo, incuac ticaquizque ye totlachuitz zazotlen, zan tinechhuilaniliz nocuitlapil huan tiquitaz tlenon mochihuaz.	[Entonces] les dijo el venado: —Miren, si algo nos ocurre, no se arredren; la vaca tiene sus cuernos con que defenderse; [en cuanto] a ustedes, voy a decirles:tú, cabrito, cuando oigas que se nos acerca alguno, nada más me tiras de la cola y ya verás lo que sucede.
Occepa otzatzic huey miztli, occepa otzatzic huey miztli; ocachi ye mocamiqui oquichtentzo.	El león volvió a rugir y se asustó más el cabrito.
Imán quitohua cualli mazatl: —Xi nechhuilanilli nocuitlapil yexpa huan niman nocuepaz ce huei cuauhtli huan amechpalehuiz.	Entonces le dijo el buen venadito: —Tírame de la cola tres veces y luego me transformaré en una gran águila para salvarlos.
Melac occepa ye oquicaque ocachi ye intlac; imán oquitaque huey miztli quintocatihuitz cana caxtolli tetecuantin, niman nepa imixtla oquinmicti chicuacen tetecuantin, in icuac inon oquitaque quilhuía mazatl nin oquichtentzo chipahuac: —Xi nechhuilanilli no cuitlapil.	[Y], de veras, volvieron a oírlo [rugir] más cerca [y] luego vieron al león que venía siguiendo a quince lobos y allí, delante de ellos, mató a seis lobos. ~~~ Cuando vieron eso, le dijo el venado al cabrito blanco: —¡Tírame de la cola!
Ocuilanilli huan niman omecuep ce huei cuauhtli.	Tiró de ella y se convirtió en una gran águila.
Chichi huehue omotlalitihuetz ipan icuecuechte, oquichtentzo iztac omotlalli otlatecacalo ipan iacol.	El perro viejo echó un brinco para sentarse sobre su pescuezo, el cabrito blanco se acomodó a horcajadas sobre su hombro.
Niman opatlan ica tlacpac huan huei miztli za omocatlachiaya ica tlacpac mazatl omocuep cuauhtli.	Luego alzó el vuelo y el león se quedó asustado mirando para arriba cómo el venado se había convertido en águila.
Oncan, zan que mazacuauhtli oquitac ye oya huei miztli, otemoc ica icnihuan huan occepa ocuilanilli icuitlapil huan occepa omocuep mazatl.	Y sucedió que en cuanto el venadoáguila vio que se había ido el león se abatió con sus hermanos [a cuestas] y de nuevo le tiraron de la cola y otra vez convirtióse en venado.
Huan cecpa noiqui ye ohualaya cente hueimiztli, cente ocelotl, huan occequintin yolcame, mazatl oquincac.	Y en otra ocasión también [ocurrió que] vieron venir a un león, a un tigre y a otros animales; el venado los oyó [venir].
Oncan quilhuía imicnihuan: —Xi motlachilican, ye huitz non amo techixitani.	Entonces les dijo a sus hermanos: —¡Miren! ~~~ Ya viene el que no nos puede ver.
Tlen oquicin oquichtentzo iztac ocuilanilli icuitlapil mazatl, haun omocuep ce cualli huei tlilmiztli, huan cuac mochtin inin yolcame itlac in tepetlaoztotl oacique, omixti in huei tlilmiztli huan quimilhuía: —Canin anyahue, caulli yolcame?	Lo que hizo el cabrito blanco fue tirar de la cola al venado y éste se transformó en una pantera, y cuando todos aquellos animales habían llegado cerca de la cueva, salióles al frente el leopardo y les dijo: —¿A dónde se dirigen, buenos animales?
Onahuat hueimiztli: —Otimitz itaco, xitechtlati itic mocal. ~~~ Nican que anquita zan nehua cualli niactica; amehuan zazan an miactin huan amo onaquizque. —Tehuan otemitziztiquizaya, huan zan nican totlatizquíayan techtocatihuitze cequin tlaca; quinequi techmotlazque huan ya inon techchihualtia ticholozque.	Respondióle el león: —Venimos a verte; escóndenos en tu casa. —Aquí, como ven, apenas quepo bien yo; ustedes son muchísimos y no han de caber. —Nosotros salimos a verte y sólo tratábamos de escondernos aquí [porque] nos vienen siguiendo algunos hombres; nos quieren cazar y eso nos obligó a huir.
Ocachi cualli ye tiehue.	Lo mejor es que nos vayamos ya.
Tlazocamati.	Gracias.
Zan opanoque huan oyaque.	Siguieron adelante y se fueron.
Zan que opanoc nemotilli occepa ocuilanilique icuitlapil huei tlilmiztli huan occepa omocuep mazatl.Oncan za oquiquiztinemía mamazatl huan cecpa ayecmo ocalaquico ichan; icompa oquimotlaque.	Tan pronto y les pasó el susto, tiraron de la cola del leopardo y éste transformóse de nuevo en venado.Después, el venadito salía con mucha frecuencia y una vez ya no volvió a su casa; le dieron caza en algún lugar.
Nin chichi huehue omic.	Aquel perro viejo se murió.
Oquichtentzo ica cihuacuacue oquitocaque. ~~~ Imán omocaque za in ceceltoton.	El cabrito y la vaca lo enterraron y se quedaron solitos.
Oquizque noiqui omotlacual temolito, huan occepa omocuepaya itic in tepetlaoztotl.	Salían también a buscar qué comer y de nuevo regresaban a la casa.
Huan cecpa omononotzaya, huan omolhuiaya, que cihuacuacue, huan que oquichtentzo. —Tlenon taxticate?	Alguna vez que conversaban, se decían tanto la vaca como el cabrito: —¿Qué hacemos aquí?
Za toceceltoton.	¡Tan solos como estamos!
Man tiacan!	¡Vámonos!
Ya za nican otocaltzacuaco.	Aquí nada más estamos encerrados.
Quitohua cihuacuacue: —Melahuac.	Dijo la vaca: —De veras.
Man tiacan!	¡Vámonos!
Cecente ocan iohui huan axan zan ye zacacuatinemi ica cuauhtlatli ica ixtlahuapa.	Cada quien cogió su camino y hoy todavía andan paciendo por el bosque y por el llano.
[END OF DOCUMENT].	[END OF DOCUMENT].
[NEW_DOCUMENT: DOCid=13, lang=nah, DOCNAME=CIZUANTON HUAN YOLCATL ].	[NEW_DOCUMENT: DOCid=13, lang=spa, DOCNAME= LA DONCELLA Y LA FIERA ].
CIZUANTON HUAN YOLCATL .	LA DONCELLA Y LA FIERA .
Oyeya cente puchtecatl oquipiaya yeyi ipilhuan zuantoton, cosa cuacualtzitzin.	Éste era un mercader [que] tenía tres hijas mujercitas, muy lindas.
Nochipa cuac oyaya tlanamacatin oquintlahtlaníaya tlenon oquinequía quinhualiquiliz; nochipa oquihtlaniliaya cecente itlaquen cuacualtzitzin.	Cada vez que iba a vender les preguntaba qué cosa querían [que] les trajese, [y] siempre le pedía cada una un traje muy bonito.
Cecpa, inon oc achi tzitziquitzin, yocmo oquinec hualiquiliz itlaquen, zan oquihtlanili cente xochitl.	Una vez, la menor ya no quiso [que] le trajese su vestido; solamente le pidió una flor.
Niman puchtecatl oya otlanamacato.	Luego el mercader se fue a hacer sus negocios.
Oipan yohuac ipan ohtli cuac oquitac cente tlatlahuilli omotaya huehca; inin oya ic ompa canin oyeya tlatlahuilli; oacito ompa; open tlatlapaloa huan nian aquin oquinanquiliaya; ocalac ictic cente cahuayocalli huan oquitac: oyeya miac ca/tw<ryotlacualli.	Le anocheció en el camino [y] entonces vio una lucecita [que] brillaba a lo lejos; se dirigió hacia donde estaba la lucecita; [cuando] llegó [a la casa] saludó y [en vista de que] nadie le contestaba, entró a una caballeriza y vio [que] había mucho forraje para caballos.
Niman inin yocochmiquía; open quitemoa canin cochiz huan oquihto: —Tía acá huallaz, nictlaxtlahuiliz tlenon yoquicuah nocahuayo.	Luego le entró sueño [y] diose a buscar [un lugar en] donde acostarse, diciendo: —Si alguno viniese, le pagaré lo que haya comido mi caballo.
Niman inin yoyaya motecaz imán oquittac cente tlatzacualli otlapohtaya; ocalac huan oquinextito miac tlacualli; open tiotlac tlacua.	Ya [estaba a punto de] acostarse [en el suelo], cuando vio una puerta abierta; entró [por ella] y encontró [una sala con] mucha comida.
Inin imán yotlacua, oc cepa yotlacua, oc cepa yoquinequía motecaz, cuac oquittac oc cente tlatzacualli; tlapohtica, oc cepa ocalac; oquittac cente tlapechtli cuahcualli.	Empezó a cenar. ~~~ En cuanto comió, pensó de nuevo en acostarse, y entonces vio otra puerta abierta. ~~~ Entró por ella [y] vio una cama muy bonita.
Zan oquihto ictic iyollixco omotlahtlani: —Tlenon nopan nochihua?	Se preguntó a sí mismo: —¿Qué es lo que me pasa?
Niman omotecac; omomahmalli; nochi itzotzoma oquitlali ipan cente icpaltontli.	En seguida se acostó, se desnudó [y] puso toda su ropa sobre una sillita.
Niman inin omotecac. ~~~ Yocmo oc cepa oízac.	Acostóse y se durmió tranquilo.
Moztlatica oízac; oquitemoaya itzotzoma zolhtic; yocmo onez; oquittac: ompo oyeya cente cuacualli tzotzomahtli.	A la mañana siguiente, cuando despertó, buscó sus vestidos viejos [y] ya no parecieron; en cambio vio que había allí un traje muy bonito.
Ornen huan omaqui inon tzotzomahtli yancuic.	Se levantó y se puso aquel traje nuevo.
Yoyaya, imán oquittac tlacualolhtlapechtli; open omacehuía; otlaque huan ayac oquittaya.	Ya se iba, [y] entonces vio una mesa puesta; sentóse a comer, y acabó de comer y no veía a nadie.
Nin open quihtoa: —Axan nehua ye niah huan nicmaca miac tlazohcamachiliztli.	Empezó a decir: —Ahora yo ya me voy y doy muchas gracias.
Niman yoquiztaya, imán oquitac miac xochime otocataya; oquilhnamic cuiquiliz iconen cente xochitl quihtoa: —Nehuatl niah nictequiz cente xochitl.	Cuando salía, vio muchas flores sembradas [y] recordó [que debía] llevar a su hija una flor; [entonces] dice: —Yo voy a cortar una flor.
Imán yoquitec oquiztiquiz cente yolhcatl huan open quihcahuatza, quilhuía: —Axan niah timitzcuaz.	En cuanto la cortó, vio salir una fiera que empezó a amenazarlo diciéndole: —Ahora te voy a comer.
Oquito puchtecatl: —Amo xi nechcua, tía xiquitta, nehua onictec inin xochitl zan onechilhui no conen nichuiquiliz cente xochitl.	[Entonces] le dijo el mercader: —No me comas; mira: yo corté esa flor sólo [porque] me dijo mi hija [que] le llevara una flor.
90Quilhuía yolhcatl: —Ma amo timitzcuaz tía ticonanatin mo conen: ipan yeyi tonalhtin ye nican tica, tlamo tihuallaz ipan yeyi tonalhtin, timitzanatin huan timitzcuaz.	91Dícele la fiera: —No te comeré si vas a traer a tu hija; dentro de tres días ya estarás aquí; si no vinieses dentro de tres días, iré a buscarte y te comeré.
Oya puchtecatl; oacito ichan; oyolhmamantaya; quitlahtlanía cizuonton inon ocachi tzitziquitzin quilhuía: —Tlenon mitzmaca?	Fuese el mercader; llegó a su casa; iba muy triste; le pregunta la muchacha más pequeña: —¿Qué te pasa?
Itlah mitzcocoa?	¿Te duele algo?
Itlah oticpolo?	¿Has perdido alguna cosa?
Xi nechilhui.	Dímelo.
Oquihto: —Nococonen, nian amo nicnequi timitzilhuiz; tía xiquitta, onicalaquito ictic cente calli, Open quinonotza quenin ipan mochi quilhuía: —Tehua ontinechilhui man timitzhualiquiliz cente xochitl: onictequito huan ocualan yolhcatl onechilhui tía amo timitzhuicaz, nechcuaquin.	Le contestó: —Hija mía, no quisiera decírtelo; mira: fui a entrar a una casa, —[y] comenzó a contarle lo que le pasó, diciéndole: "Tú me dijiste que te trajera una flor; la fui a cortar y se enfureció la fiera [y] me dijo [que] si no te llevaba, vendría a comerme."
Oquihto cizuanton: —Tiohue man techcua tonehuan.	[Entonces] le dijo la doncella: —Vamos a que nos devore juntos.
Oyahque; oacito huan ayac oquittaya.	Se fueron, llegaron y no la vio.
Opanoque miac tonalhtin quilhuía itata: —Axcan tiah timitzcahuaz, nian niquimittatin mocnihuan.	Se pasaron muchos días [y] le dijo su papá: —Ahora voy a dejarte, voy a ver a tus hermanas.
Oquicahten icecelton huan inin cizuanton oquitlapatiliaya momoztla itlaquen huan amo oquimatia aquin oquitlapatiliaya.	La dejó sólita, y todos los días le cambiaban de vestido a aquella doncella, y no sabía quién se lo cambiaba.
Niman imán yopanoque miac tonalhtin open cuicaqui quilhuía: —Cualli cizuanton nehua nicnequi nitlacuaz ca tehuatl.	Cuando habían pasado muchos días, comenzó a oír [que] le decían: —Hermosa doncella, yo quiero comer contigo.
Inon oquicaquia itzintla cuahtlatzacualli.	Tal oía [decir] debajo de la puerta de madera.
Inin cizuanton open mamana huan yoquinequia yaz quimittatin itata ca icnihuan.	Aquella doncella comenzó a afligirse y quería ir a ver a su papá y hermanas.
Imán ce tonalli, zan oc huatzinco ornen, oquittac: ompaca cente amatlahcuilolli canin oquilhuitaya inon yolhcatl man huia ichan man quimittati icnihuan ca itata; noihqui oquilhuitaya ipan itzoncuac oyeya cente cuahcuahuitl: Tía ticnequi tiaz, zan xi quehtzoma inin cuahcuahuitl huan niman mitzhuicaz mochan; noihqui niman tihuallaz ipan yeyi tonalhtin; tía amo tihuallaz ipan yeyi tonalhtin, tinechnextitin yonicic.	Un día se levantó muy de mañana y vio que allí estaba una carta en que le decía la fiera que fuese a su casa a ver a sus hermanas y a su papá, y también le decía [que] encima de su cabecera había una varita. —Si quieres ir, muerde nada más esa varita y en seguida te llevará a tu casa; así también volverás dentro de tres días.
Mellahuac, zan oquiquehtzoma inon cuahcuahuitl imán oquittac, oyeya ca itata huan ca icnihuan.	Si no vinieses dentro de tres días, me encontrarás ya muerto.
Niman icnihuan amo oquicahque mocuepaz ipan yeyi tonalhtin huan imán omocuep yolhcatl yomic.	Y, de veras, apenas mordió aquella varita, en seguida se vio con su papá y hermanas.
Niman open choca cizuonton; open quixayacapetzoa, quilhuía:—Tleca otimic cualli yolhcatl.	Después, sus hermanas no la dejaron regresar a los tres días, y cuando regresó, la fiera ya había muerto.
Ihqui oquilhuitaya cuac ocochmic; niman otlatemic nelli oquilhui yolhcatl: —Xictequi cente xochitl huan tinechchichipiniliz ipan noixcuac inon atzintli quipia xochitl.	
Niman oizac huan oquitequito xochitl huan oquichichipinili ipan ixcuac, niman omehtiquiz inon yolhcatl huan omocuep cente pilhtontli cuacualtzin huan omozuahtique.	Entonces la doncella se echó a llorar y a acariciar la cara [a la fiera], diciendo: —¿Por qué moriste, fiera bondadosa?
[END OF DOCUMENT].	Así diciendo quedóse dormida [y] entonces soñó que le decía la fiera:Publicado en Ethnos, con el título "Cizuonton van Yolhcatl" [END OF DOCUMENT].
[NEW_DOCUMENT: DOCid=14, lang=nah, DOCNAME=PILTONTLI AMO OTETLACAITAYA ].	[NEW_DOCUMENT: DOCid=14, lang=spa, DOCNAME= EL MUCHACHO DESOBEDIENTE ].
PILTONTLI AMO OTETLACAITAYA .	EL MUCHACHO DESOBEDIENTE .
Nelli oyeya cente piltontli amo otetlacaitaya; nochipa itahuan oquilhuiaya icuac cana yaz man moixota, zan oquiquiztinemía ica ixtlahuapa ocuacuapiaya huan icuac amo ocuacuapiaya huan icayan, oyeya omaahuiltiaya inca icpac tepetl, ica tlatzalan, ica itic atlatin, icuac amo oquipiaya tequitl zan oquizaya.	Era una vez un muchacho que no obedecía; siempre sus padres le decían que se cuidase cuando fuera a alguna parte. ~~~ Cada vez que salía al campo a cuidar los bueyes y cuando no cuidaba el ganado, y tenía lugar, se iba a jugar a los cerros, por los valles, por las barrancas; cuando no tenía trabajo, nada más salía.
Zan id cecpa oquilhuique: —Tiehue timitzilhuizque totlazo conen, ximoixoti, ame cana tiquinnamiquitin ehecame huan moca mahuitl tizque. —Tlen yyolcayouan inon ehecame? —Qui!	Por fin le dijeron: —Te vamos a decir, hijo querido, que te cuides, no sea que en alguna parte topes con los aires y jueguen contigo. —¿Qué clase de animales son esos aires? —Que los Aires no son animales; esos aires se respetan. —Por eso, díganme ustedes cómo son, que yo no los conozco. —Oye lo que te voy a decir: los aires son bonitos, se visten como danzarines, tienen muchos vestidos; a veces se cambian los vestidos cuando quieren.
Amo yolcame inon ehecame; inon ehecame motlacaitani. —Nozo xinechmolhuilican quename yehuan, nehuatl amo niquimixmati. —Xiccaqui tlen tía timitzilhuiz: inin ehecame cuacualtzitzin, yeica motlaquentía que cente únelo, quipía miac tlaqueme, quemanian qumpaüa Üaqueme in icuac quinequi; quemanian ye otiquittac nin tototl itoca huitzilin non iquequecuayo huele tonal pepetlaca iquión tetica cuacualtzin, inime noiqui, iquion mo tlaquentiani huan yatinemi yohualli, intonalli; ye ticcaqui iquion ica moyectlaquentíani huan cuacualtzintzin; noíquion ica amocualli tlaca tecamahuiltiani. —Huan, que icanica niquínnextiz? —Ahuelli timitzilhuiz, ca nin tía tiquintemotin, zace amo tiquinnextiz, zan icuac yehuan quinequi mixtía.	¿Ya has visto ese pájaro que se llama chuparrosa, es así muy bonito? ~~~ Estos lo mismo así se visten y andan de noche y de día; ya oyes, así es como se visten muy bien y muy bonitos, y así, como también son malos, se burlan de uno. —¿Y por dónde los encontraré? —No podré decirte por dónde; si los vas a buscar de por sí no los encontrarás; nada más cuando ellos quieren se avistan; ya te dije: los aires no se ven y en lugares muy lóbregos se avistan y son como muñequitos; a veces se esconden, algunas veces están jugando o corriendo; y si algo vas comiendo cuando pases, les participarás. —Por eso si los veo les participaré y si no, no. —Aunque no los veas, si pasas la barranca les dejarás una pequeña parte, o sea que les pases a convidar, y si alguna cosa vas comiendo y no les participas, alguna vez llegarás con un tafetán en la boca aquí, y si nada más vas pasando y te ven, desearán, y si no les dejas convidado, de por sí te pegarán en la cara, o sea que te den jiote, y así es como juegan con uno. —Entonces ahora ya sé: cuando vaya a alguna parte me cuidaré; cuando pase por alguna parte llevaré dentro de mi bolsa tortillas y fruta y así nunca me harán nada.
Ye otimitzilhui: ehecame amo mota huan canin amo cuacualcan mixtía, quename coconeme; quemanian modada, quemanian mahuiltiticate tlahuaticate; huan tía itla ticcuati, icuac tipanoz tiquintlacotoniz. —Nozo tía niquimittaz niquintlacotoniz huan tlamo, amo. —Mazquiamo tiquimittaz, huan tatlapanoz ticquintlacotonitehuaz onoce, tiquintlacotonitiquizaz.	107—Así, siempre cargarás lo que tengas que regalarles; lo que has de hacer es cargar siempre cigarros, eso es buen remedio, ahuyenta a los aires. ~~~ Y así, cuando salía a alguna parte compraba como dos, o parece que tres cajas de cigarros y dos de cerillos. ~~~ Y como siempre se iba, una vez salió y se fue a leñar por dentro de la barranca y entonces no se acordó de comprar cigarros.
Tía itla ticuati huan amo tiquinmacaz quemanian ticalaquiquin ye omitzcamatlatzinique, huan tía zan tipanoti huan mitzitilizque huan tía amo tiquintlacotonitehuaz, zace mitzxayacatlatzinizque, onoce mitzxiomacazque; huan iquion ica maniltía ica ce. —Oya axa ye nicmati icuac cana niaz notlatlachialliz zanque 106cana nía nipanoz nicuicaz itic no poxa tlaxcalli, xochicualli, huan iquion ayic itla nechchihuilizque. —Iquión nochipa ticmamatinemiz tlen tiquintlacoliz, tlen ticchihuaz nochipa ticmamatinemiz tempitze amatlamatelolli, inon ne ce cualli patli, quinchololtia ehecame.	Llegó dentro de la barranca, dizque comenzó a leñar y olvidó con qué amarrar su leña. —Ahora voy a cortar bejuco para amarrar mi leña. ~~~ Entró por dentro del marañal y se fue a encontrar los gallitos; comenzó a cortar y comer y guardaba dentro de su bolsa, y cuando hizo remolino fue cuando se acordó que ahí dentro de ese breñal, por su izquierda vio una cueva, y luego dijo: —Aquí han de vivir los aires.
Huan iquion icuac cana oquizaya oquinmocohuiaya cana orne onoce yei caxa tempitze amatlamatelolli, huan orne caxatin tletlazaloni.	Luego se espantó, se puso pálido, ya no sabía qué hacer y se decía entre sí: "Si salgo corriendo me han de oír y me maltratarán; y si despacio me voy, me tardaré y de por sí me verán."
Huan que nochipa oyatinemía cecpa nelli oquiz oya ocuacuahuito ica itic atlaco, huan imanon amo oquilnamic orno cohuiani tempitze ama tlamatelolli ocalaquito itic atlatli nelli open cuacuahui huan oquilcan tlenica quilpiz icua quitohua axan nía nic tequiz temecatl ica niquilpiz cuahuitl ocalac ica itic tlacoyo huan oquin nextito tetequihuatin open, quintequi quincua huan occequin oquen yeyantitaya itic y poxa imán ochcamálacoc imanon oquilnamictetz ompon itic inon tlacoyo ica y opochtitla oquittac cente tepetlaoztotl huan niman oquitto. —Nican chantizque ehecame: Niman omocamic oxayaca iztalen ayecmo oquimatia tlen qui chilhuaz huan omolhuiaya zan yelhuatl tía niquiztiquizaz nechcaquizque huan nechhuitequizque huan tlazan cualli ni yayataz ni huecahuaz huan zace nech ittazque oquicacque itic oztotl otlalpitzaya ehecatl, oquitohuaya in piltontli. —Ye huitze ehecame ye hual tzicuini oquicaquía que melac maictin ohuatl tzicuinia que acá ye oyaya quiquitzquiz on quiztiquiz tic tlacoyo zan moca tzicuinia ica non otzicuinia orno quech ilpitiquiz ica centetl emecatl huan omoca mictihuetz ohuetzito ompon omocan.	Oyó que dentro de la cueva soplaba el aire y decía el muchacho: —Ya vienen los aires, ya vienen corriendo, y oía que de veras muchos venían corriendo; parece que alguno lo quería coger. ~~~ Salió corriendo asustado dentro del breñal; de la carrera que llevaba se pasó a lazar del cuello con un bejuco que llevaba y se privó; cayéndose, ahí se quedó.
Ichan ye mocamiqui amo neci te conen ye ohuecahueto opeque mo netechtlatlani. —Tle amo anconittaque no pilton? —Amotla onech onilhui oya zan ica itic calmilli. —Hueliz ye oya ica itic atlatli nonantzin xicmotemoliti hueliz ompa yez hueliz itla ipan ye omochin ye ocon moca mictique ehecame ximotzicuiniti ximotiliti.	En su casa se asustaron de ver que no aparecía su hijo. ~~~ "Ya se dilató", decían, y empezaron a preguntar: —¿Qué no han visto mi muchacho? —No, si me dijo que no más iba dentro del corral. —Puede que se haya ido por dentro de la barranca, señora; vaya a buscarlo, puede ser que ahí esté y algo le ha sucedido; lo asustarían los aires, corra usted a verlo.
Niman oquixohuatin cihuapa oquitemoto ica itic atlatli.	Luego salió la mujer y fue a buscarlo por dentro de la barranca.
Melac oquinextito ompa tilantoc in te conen; opehuihuac moca tzatzihua chocoa ya ye oquimixtique ehecame huan nican hueliqui quichichina tetempitze amatlamatelolli.Oecoque tlamamaque huan ocuicaque ichan niman oquinotzato tepati man quittaqui in te pilton ye omoehecahui man quipatiqui.	De veras lo encontró que ahí estaba atado su hijo; empezó a gritar de miedo y a llorar, pues ya lo habían muerto los aires, y aquí recio fumaba el cigarro.
Ohuala tepati huan niman opeuh quipatía oquitzetzelo itic cente ayatl oncan oquipatzo ipan ite oqui itique axixtli (apiaztli), huan occequipa tli oca alahuilique moztlatica zan ocuatzin co yeoquitato occepa in te pati. —Quilhuía que tamía que otlitlathuitl? —Cualli ximocalaqui.	Llegaron los cargadores y se lo llevaron a su casa; luego fueron a llamar a la curandera, que venga a ver a su muchacho, ya se enfermó de aires, y que lo venga a curar.
Nican tena, tena, tena, quimach cualli onahuatía. —Oncan quitlatlania ye ticeti. —Ye cualli, tica?	Vino la médica yluego empezó a curarlo.
Nechilhui, tlenon otietcmoto ica itic atlatli? —Onon cuacuahuito. —Tle amo ticmati que iconpon amo cuacualcan?	Lo sacudió dentro de un ayate y después lo sobó en la barriga; le dieron a beber orines, y le untaron otras medicinas; al otro día muy temprano fue a ver al enfermo la médica y le dijo: —¿Cómo te sientes, cómo amaneciste? —Bien, pase usted.
Zan iconpa, yayactinemi ehecame, amo cualli tlaca huan zanti.	Aquí se quejaba, se quejaba, apenas podía responder.
Iconpa, yayaticnemi ehecame; amo cualli tlaca huan zan ti yayatinemi?	Después le preguntó: ¿Ya te alivias un poco?
Amo cuali xitlacaqui ye titlacamelactic amo zan xiquiquiztinemi.	Dime: ¿qué fuiste a buscar dentro de la barranca? —Fui a hacer leña. —¿Que no sabes que esos lugares son muy peligrosos?
Canin o noce quenin omitz moca mictique ehecame? —Onopacho itlac cente oztotl huan oniquincac que ohualtzicuinia que onech tocaya. —Nozo otiquimittac? —Quema oniquimittac. —Quename yehuan? —Oniquimittac que coconeme yectlaquemeque que cineloque huan coza petlanía intlaqueme timotillizquia quename non quatlaltototl petlani ihuihuan que xoxoctica chichiltic incuac cuitequi in tonalli iquión ica te ixmimicti. —Nochi cuallica, axan nía timitzpatiz huan moztla timitzitaquin, quen otillathuilli.	Nada más por ahí ya andan los aires, son muy malos y nada más te vas; no es bueno, oye, ya entiendes, no nada más te andes saliendo. ~~~ ¿En dónde, o más bien, cómo te asustaron los aires? —Me acerqué junto a una cueva y los oí que venían corriendo; parece que me seguían. —Por eso, ¿los viste? —Sí, los vi. —¿Cómo son ellos? —Los vi: son como muñecos bien vestidos, como los bailarines, y mucho brillan sus trajes; si viera usted, se parecen a ese pájaro de primorosas plumas como tornasolado, que cuando le da el sol, así, deslumhra la vista. —Todo está bien, ahora voy a curarte y mañana te vendré a ver cómo amaneces.
Oquipati. —Oncan occepa oqui tlatlanihuan amitla occe otiquitac in icuac omitz tocaya ehecame? —Quenamo. —Tlenon?, xinechilhui. —In icuac oniquiztiquiz onechtocaya huan onechtzonhuique ica temecatl imán onechtlalcueponique huan ompon onocan oyecmoonicmatl tlemon occe onechchihuilique.	Lo curó; volvió otra vez a preguntarle: —¿Y no viste otra cosa cuando te seguían los aires? —Cómo no. —¿Qué cosa?, dime. —Cuando salí corriendo, me seguían y me lazaron con el bejuco; fue cuando me dieron el golpe y ahí me quedé; ya no supe qué otra cosa me hicieron.
Inin piltontli ocehuic huan ipan ce xitica occepa orno coco zan oquixayaca tlatzinique ehecame huan ica inon omic.	Este muchacho se alivió y al siguiente año otra vez se enfermó: lo cachetearon los aires y con eso murió.
[END OF DOCUMENT]	[END OF DOCUMENT]
