Amo el canto del cenzontle,pájaro de cuatrocientas voces,amo el color del jadey el enervante perfume de las flores,pero más amo a mi hermano: el hombre.	Nehuātl niktlasohtlain sentsontōtōtl ikwīkau,nehuātl niktlasohtlain chalchiuitl itlapālisīuān in auiakmeh xōchimeh;san ok senka noikniutsin in tlākatl,Nehuātl niktlasohtla
Estoy embriagado, lloro, me aflijopienso, digo,en mi interior lo encuentro:si yo nunca muriera,si nunca desapareciera.Allá donde no hay muerteallá donde ella es conquistada,que allá vaya yo…Si yo nunca muriera,si nunca desapareciera.	Niwinti, nichoka, niknotlamati,nik mati, nikihtoa,nik ilnamiki:Ma ka aik nimikima ka aik nipoliwi.In kan ahmikoa,in kan on tepetiwa,in ma onkan niaw…Ma ka aik nimiki,ma ka aik nipoliwi.
No acabarán mis flores,no cesarán mis cantos.Yo cantor los elevo,se reparten, se esparcen.Aun cuando las flores / se marchitan y amarillecen,serán llevadas alláal interior de la casa / del ave de plumas de oro.	Ah tlamis noxochiwah tlamis nokwikin nokon ya ewa / san nikwikanitlXexeliwi moyawakosawia xochitl:ye on kalakilosakwan kalitik.
Soy rico,yo, el señor Nezahualcóyotl.Reúno el collar,los anchos plumajes de quetzal,por experiencia conozco los jades,¡son los príncipes amigos!Me fijo en sus rostros,por todas partes águilas y tigres,por experiencia conozco los jades,las ajorcas preciosas…	Ye nonnokwiltonowa,on nitepiltsin, Nesawalkoyotl.Niknechiko koskatl,in ketalin patlawak,ye nonik-iximatin chalchiwitl,¡in tepilwan!Ixko nontlatlachia,nepapan kawtlin, oselotl,ye nonik-iximatin chalchiwitl,ya in makistli…
Yo Nezahualcóyotl lo pregunto:¿Acaso deveras se vive con raíz en la tierra?No para siempre en la tierra:sólo un poco aquí.Aunque sea de jade se quiebra,aunque sea de oro se rompe,aunque sea plumaje de quetzal se desgarra.No para siempre en la tierra:sólo un poco aquí.	Nikihtoa ni-Nesawalkoyotl:¿Kwix ok neli nemowa in tlaltikpak?An nochipa tlaltikpak:san achika ya nikan.Tel ka chalchiwitl no xamani,no teokwitlatl in tlapani,no ketsali posteki.An nochipa tlaltikpak:san achika ye nikan.
Estoy triste, me aflijo,yo el señor Nezahualcoyotlcon flores y con cantos,recuerdo a los principesa los que se fuerona Tezozomoctzin,a Cuacuahtzin.	Nitlayokoya, niknotlamatiyasan, nitepiltsin Nesawalkoyotlxochitika ye iwan kwikatikanikimilnamiki tepilwan,ain oyake,yehwa Tesosomoktsin,o yehwan Kwahkwahtsin.
En verdad viven,allá en donde de algún modo se existe¡ojalá pudiera yo seguir a los principesllevarles nuestras flores!¡Si pudiera yo hacer míoslos hermosos cantos de Tezozomoctzin!Jamás perecerá tu renombre¡Oh mi señor, tu Tezozomoctzin!Así, echando de menos tus cantosme he venido a afligirsolo he venido a quedar tristeyo a mí mismo me desgarro	Ok nelin nemoan,kenonamikan.¡Maya nikintoka in intepilwan,maya nikimonitkili toxochiw!Ma ik itech nonasi,yektli yan kwikatl in Tesosomoktsin.O aik ompoliwis in moteyo,¡nopiltsin, Tesosomoktsin!Anka sa ye in mokwik a ikaniwalchoka,in san niwaliknotlamatiko,nontiya.
He venido a estar triste, me aflijoya no estas aquí, ya no,en la region donde de algún modo se existe,nos dejate sin provision en la tierrapor esto, a mí mismo me desgarro.	San niwalayokoya, niknotlamati.Ayokik, ayok,kenmanian,titechyaitakiw in tlaltipak,ika nontiya.
Yo Nezahualcóyotl lo pregunto:¿Acaso deveras se vive con raíz en la tierra?No para siempre en la tierra:sólo un poco aquí.Aunque sea de jade se quiebra,aunque sea de oro se rompe,aunque sea plumaje de quetzal se desgarra.No para siempre en la tierra:sólo un poco aquí.	Nikihtoa ni-Nesawalkoyotl:¿Kwix ok neli nemowa in tlaltikpak?An nochipa tlaltikpak:san achika ya nikan.Tel ka chalchiwitl no xamani,no teokwitlatl in tlapani,no ketsali posteki.An nochipa tlaltikpak:san achika ye nikan.
Percibo lo secreto, lo oculto:¡oh vosotros señores!	San nikkaki itopyo, ipetlakalo: ¡Ah in tepilwan!
Así somos, somos mortales,de cuatro en cuatro nosotros los hombres,todos habremos de irnos,todos habremos de morir en la tierra…	Timasewaltin, nawi, nawi, in timochi tonyaske, timochi tonmikiske in tlatikpak…
Nadie en jade,nadie en oro se convertirá:en la tierra quedará guardado.	Ayak chalchiwitl, ayak teokwitlatl mokwepas: in tlaltikpak tlatielo.
Todos nos iremosallá, de igual modo.Nadie quedará,conjuntamente habrá que perecer,nosotros iremos así a su casa.	Timochi tonyaske in kanin, ye iwkan Ayak mokawas, san sen tlapopoliwis, tiyawi ye iwkan ichan.
Como una pintura,nos iremos borrando.Como una flor,nos iremos secandoaquí sobre la tierra.	San iwki tlakwiloli ah tonpopoliwi. San iwki xochitl, in san tonkwetlawi ya in tlaltikpak.
Como vestidura de plumaje de ave zacuán,de la preciosa ave de cuello de hule,nos iremos acabando,nos vamos a su casa.	Ya ketsali ya sakwan. xiwkecholi itlakechwan, tonpopoliwi, tiyawi in ichan.
Se acercó aquí,hace giros la tristezade los que en su interior viven…	Oasiko ye nikan, ye ololo a in tlaokol ye in itek on nemi…
Meditadlo, señores,águilas y tigres,aunque fuerais de jade,aunque fuerais de oro,también allá iréis,al lugar de los descarnados…	Xik yokoyankan, in antepilwan, kwawtamoselo, ma nel chalchiwitl, ma nel teokwitlatl, no ye ompa yaske, onkan on Ximowa…
Tendremos que desaparecer,nadie habrá de quedar.	San tipopoliwiske, ayak mokawas.
En la casa de las pinturascomienza a cantar,ensaya el canto,derrama flores,alegra el canto.	Amoxkalkopewa kwika,yeyekowa,kimoyawa xochitl,on awia kwikatl.
Resuena el canto,los cascabeles se hacen oír,a ellos respondennuestras sonajas floridas.Derrama flores,alegra el canto.	Ikawaka kwikatl,oyowali ewatiwits,san kinankiliyatoxochayakach.Kimoyawa xochitl,on awia kwikatl.
Sobre las flores cantael hermoso faisán,su canto despliegaen el interior de las aguas.A él respondenvariados pájaros rojos.El hermoso pájaro rojobellamente canta.	Xochitikpak kwikain yektli kokoxki,ye kon ya totoma aitek.San ye konnankiliain nepapan kechol.In yektli kechol,in wel ya kwika.
Libro de pinturas es tu corazón,has venido a cantar,haces resonar tus tambores,tú eres el cantor.En el interior de la casa de la primaveraalegras a las gentes.	Amoxtlakwilol in moyolo,tokwikatikako,in tiktsotsona in mowewew,in tikwikanitl.Xopan kala itek,in tonteyawiltiya.
Tú sólo repartesflores que embriagan,flores preciosas.	San tik moyawain poyoma xochitli,in kakawa xochitli.
Tú eres el cantor.En el interior de la casa de la primavera,alegras a las gentes.	In tikwikanitl.Xopan kala itek,in tonteyawiltiya.
Tlen ome Tlanauatijkayotl. Tomexijko Tlalnantsin san se iuan amo moxelos.	Articulo 2o.- la Nación Mexicana es única e indivisible.
Totlalnantsin monelchiua iuan moneluayotia ipan miakintin maseual altepemej tlen ualauij ipan kalpolmej tlakamekayotl chanchijkej ipan Anauak totlalnantsin tlen keman opejki yankuik chantilistli iuan mopialia tlen yeuan tlanauatikayotl, tlapialistli, toltekayotl iuan tlatolkayotl, noso san achitsin tlen yeuan.	La Nación tiene una composición pluricultural sustentada originalmente en sus pueblos indígenas que son aquellos que descienden de poblaciones que habitaban en el territorio actual del país al iniciarse la colonización y que conservan sus propias instituciones sociales, económicas, culturales y políticas, o parte de ellas.
In tlayolmatilistli tlen maseual ixtli iuan yolojtli yeua kiijtos ajkia uelis kiselis tlanauatilmej tlen maseual altepemej.	La conciencia de su identidad indígena deberá ser criterio fundamental para determinar a quienes se aplican las disposiciones sobre pueblos indígenas.
In kalpolmej tlen maseual altepemej, yeuan tlen mosen nechikojtokej, kipiaj tlapialistli iuan tlaiyokalistli, mochantlalijtokej ipan tlaltipaktli iuan kineltokaj tlen yeuan intekiua tlen ualaj ipan intlaneltokilis.	Son comunidades integrantes de un pueblo indígena, aquellas que formen una unidad social, económica y cultural, asentada en un territorio y que reconocen autoridades propias de acuerdo con sus usos y costumbres.
In tlatechpouilistli tlen maseual altepemej tlen ika mosennauatisej uelis mochiuas ipan se tlachiuali sentlanauatili tlen melauak kitlepanitas sentika Anauak tlaltipaktli. In tlakaitalistli tlen kalpolmej iuan maseual altepemej mochiuas ipan Amatlanauatilmej iuan tlajtoltlanauatilmej tlen Tlaltlanauatiloyan, iniuantijya moneki kiitasej, nochi tlen moijtoua ipan tlaneltokilistli tlen inin tlanauatikayotl, noijki tlayeyekoli tlajtolmekayotl iuan tlalchantilistli.	El derecho de los pueblos indígenas a la libre determinación se ejercerá en un marco constitucional de autonomía que asegure la unidad nacional. El reconocimiento de los pueblos y comunidades indígenas se hará en las constituciones y leyes de las entidades federativas, las que deberán tomar en cuenta, además de los principios generales establecidos en los párrafos anteriores de este articulo, criterios etnolingüísticas y de asentamiento físico.
A. Inin Amatlanauatili kikualita iuan kimanauia tlatechpouilistli tlen maseual altepemej iuan kalpolmej tlen ika uelis mosennauatisej iuan ika yeua mosenchanchiuasej tlen ika uelis:	A. Esta Constitución reconoce y garantiza el derecho de los pueblos y las comunidades indígenas a la libre determinación y, en consecuencia, a la autonomía para:
I. Kiijtose kenijki mosenuikasej iuan monauatisej, moyolchikauasej, moyekanasej iuan kiyeyekosej tlaiyokalistli.	I. Decidir sus formas internas de convivencia y organización social, económica, política y cultural.
II. Kitekiuis tlen yeuan intlanauatil tlen ika uelis kixoleuasej kualantli, moixkuisej ipan ueueyi tlayeyekoli tlen ixnesi ipan Amatlanauatili, motlepanitas tlanauatil nemilistli, tlakanemilistli iuan kachi nelkuali, siuayotl tlatlepanitalis. In tlanauatili kiyektlalis tletleno tlajtoli iuan ojtlajtoli tlen ipatij kichiuasej tlajtoltlasekauanij iuan kaltekichiuanij.	II. Aplicar sus propios sistemas normativos en la regulación y solución de sus conflictos internos, sujetándose a los principios generales de esta constitución, respetando las garantías individuales, los derechos humanos y, de manera relevante, la dignidad e integridad de las mujeres. La ley establecerá los casos y procedimientos de validacion por los jueces o tribunales correspondientes.
III. Kin tekiuatlalis, ken kijtoua ueuetlajtoli iuan uekapa tlanauatili, tekiuekemej tlen kiyekanasej tekiuekayotl tlen maseual altepeyotl, kitlepanitasej tlapaleuilistli tlen siuamej sentikaj ipatij iniuaya tlakamej, ipan se tlajtolmekayotl tlen kitlepanitas tlajtolmachiotl tlen nochi totlalnantsin iuan sentlanauatikayotl tlen tlaltlanauatiloyan.	III. Elegir de acuerdo con sus normas, procedimientos y prácticas tradicionales, a las autoridades o representantes para el ejercicio de sus formas propias de gobierno interno, garantizando la participación de las mujeres en condiciones de equidad frente a los varones, en un marco que respete el pacto federal y la soberanía de los estados.
IV. Moajokuis iuan moyolchikauas inneltlajtol, intlamatilis iuan nochi tleueli iyokalistli iuan tlaixnestilistli.	IV. Preservar y enriquecer sus lenguas, conocimientos y todos los elementos que constituyan su cultura e identidad.
V. Moyektlalis iuan mokualtlalis chantilistli iuan momaluis intlalua ken ixnesi ipan inin Amatlanauatili.	V. Conservar y mejorar el hábitat y preservar la integridad de sus tierras en los términos establecidos en esta Constitución.
VI. Moasikamatis, san moneki motlepanitas nochi tlamantli tlen ixnesi ipan Amatlanauatili iuan tlanauatilamatl tlen itechpoui, noijki intechpouilistli tlen sekinok moaxkatijtokej noso tlen chantij ipan kalpolmej, uelis motekiuis nochi tlen onkaj ipan totlalnantsin kampamo chanchiuaj maseual altepemej, san amo tlen sentika tlatekiuilistli tlen kiijtoua Amatlanauatili. Tlen ika inin tlajtoli maseual kalpolmej uelis mosen nechikosej ken kijtoua tlanauatili.	VI. Acceder, con respeto a las formas y modalidades de propiedad y tenencia de la tierra establecidas en esta constitución y a las leyes de la materia, así como a los derechos adquiridos por terceros o por integrantes de la comunidad, al uso y disfrute preferente de los recursos naturales de los lugares que habitan y ocupan las comunidades, salvo aquellos que corresponden a las aéreas estratégicas, en términos de esta constitución. Para estos efectos las comunidades podrán asociarse en términos de ley.
VII. Kin tekiuetlalis, ipan maseual altepemej tlanauatiloyan, tlen ixnesisej ipan altepetlajtokan.	VII. Elegir, en los municipios con población indígena, representantes ante los ayuntamientos.
In Amatlanauatilmej iuan tlanauatilmej tlen tlaltlanauatilmej, kitlepanitasej iuan kitekpanasej inin tlanauatilmej ipan altepemej tlanauatiloyan, tlen ika uelis kiyolchikauasej tlapaleuilistli y tlanauatili ixnestilistli ken moijtoa ipan ueuetlajtoli iuan maseual tlanauatili.	Las constituciones y leyes de las entidades federativas reconocerán y regularan estos derechos en los municipios, con el propósito de fortalecer la participación y representación política de conformidad con sus tradiciones y normas internas.
VIII. Mosentlalis ipan nochi tlaltlanauatijkayotl. Tlen ika uelis momanauis tlatechpouilistli, ipan nochi tlajtolmatilistli iuan intlayeyekolpamitl kampa ixnesisej, iseltika noso sentika, moneki motlepanitas intlachiualis iuan intlayeyekolistli ken moijtoa ipan Amatlanauatili. In maseualmej nochi kauitl kipiaj tlatechpouilistli mopaleuisej iuaya se tlajtolkuepketl iuan temanauiani tlen kiixmatij maseualtljtoli iuan maseual iyokalistli.	VIII. Acceder plenamente a la jurisdicción del estado. Para garantizar ese derecho, en todos los juicios y procedimientos en que sean parte, individual o colectivamente, se deberán tomar en cuenta sus costumbres y especificidades culturales respetando los preceptos de esta Constitución. Los indígenas tienen en todo tiempo el derecho a ser asistidos por intérpretes y defensores que tengan conocimiento de su lengua y cultura.
In amatlanauatilmej iuan tlajtoltlanauatilmej tlen tlaltlanauatilmej kineskayotisej kenijki mosennauatisej iuan mosenchanchiuasej tlen kachi kuali kinextis tlenon kiixneuiaj iuan kiyeyekouaj maseual altepemej ipan se tlaltlanauatiloyan, iuan noijki tlajtoltlanauatili tlen ika kin ixitasej maseual altepemej ken se kalpolmej tlapaleuikayotl.	Las constituciones y leyes de las entidades federativas establecerán las características de libre determinación y autonomía que mejor expresen las situaciones y aspiraciones de los pueblos indígenas en cada entidad, así como las normas para el reconocimiento de las comunidades indígenas como entidades de interés público.
B. In Sentlanauatiloyan, Tlaltlanauatiloyan iuan Altepemej Tlanauatiloyan, iuikpa uelis kinsenpaleuisej maseualmej iuan kipoliuiltisej tletleno tlaixpinaualtilistli, kiyolitisej kaltlanauatilmej iuan kiixnextisej tlajtoltekitl tlen ika temachtli mochiuas tlatechpouili tlen maseualmej iuan yolchikauilistli tlen altepemej iuan kalpolmej, tlen yeuan kisentika chiuasej iuan sentika tekichiuasej.	B. La Federación, los estados y los municipios, para promover la igualdad de oportunidades de los indígenas y eliminar cualquier práctica discriminatoria, establecerán las instituciones y determinaran las políticas necesarias para garantizar la vigencia de los derechos de los indígenas y el desarrollo integral de sus pueblos y comunidades, las cuales deberán ser diseñadas y operadas conjuntamente con ellos.
Iuikpa uelis mokotonas motolinikayotl tlen kinkokolismaka in maseual altepelemej iuan kalpolmej, in tekiuekamej monekiliaj:	Para abatir las carencias y rezagos que afectan a los pueblos y comunidades indígenas, dichas autoridades, tienen la obligación de:
I. Chikauak mochiuas tekitl tlen ika moasis maseualyotl yolchikaualistli, iuikpa uelis kachi kuali mochantlalisej chinankomej iuan mokualtlalis intlachialis altepemej, ika tekichiualsitli tlen eyij kaltlanauatilistli, iniuaya kalpolmej. In Altepetlanauatianij kiixtlalisej nelkuali tlaxexeloli tomin tlaxtlauili tlen kalpolmej uelis kiyekanasej tlen ika mopaleuisej.	I. Impulsar el desarrollo regional de las zonas indígenas con el propósito de fortalecer las economías locales y mejorar las condiciones de vida de sus pueblos, mediante acciones coordinadas entre los tres órdenes de gobierno, con la participación de las comunidades. Las autoridades municipales determinaran equitativamente las asignaciones presupuestales que las comunidades administraran directamente para fines específicos.
II. Monelchiuas iuan momiakilis tlamachtilistli, nelkuali mopaleuis ometlajtol tlamachtilistli iuan ompamitl tlajlamikilistli, tlakuilol tlamachtilistli, motlamis iyoyok tlamachtilistli, tlamachtil tekitilistli, iuan uekapaj iuan neluekapaj tlamachtilistli. Moyeyekos se tlachiuali tlapaleuilistli iuikpa maseual momachtianij tlen nochi tlamachtikayotl. Moitas iuan mochiuas tekitlamachtilistli kampa ixnesis tlen kayotl tlajlamikilistli tlen kinextis xikneluayotl tlen maseual altepemej, ken moijtoa ipan tlajtol tlanauatili iuan noijki matlajtokan maseual kalpolmej. Moyolchikauas tlatlepanitalis iuan tlamatilistli tlen miakintin iyokalislti tlen nestikatej ipan totlalnantsin.	II. Garantizar e incrementar los niveles de escolaridad, favoreciendo la educación bilingüe e intercultural, la alfabetización, la conclusión de la educación básica, la capacitación productiva y la educación media superior y superior. Establecer un sistema de becas para los estudiantes indígenas en todos los niveles. Definir y desarrollar programas educativos de contenido regional que reconozcan la herencia cultural de sus pueblos, de acuerdo con las leyes de la materia y en consulta con las comunidades indígenas. Impulsar el respeto y conocimiento de las diversas culturas existentes en la nación.
III. Melauak mochiuas makiasikaj tlapajtilistli ika momiakilis tlen nochi Mexko tlachiuali tlapajtilistli, motekiuis maseual tlapajtilistli, iuan noijki mopaleuis tlakualistli tlen maseualmej ika tekitlanauatil tlakualistli, achi nemachyotl tlen konemej.	III. Asegurar el acceso efectivo a los servicios de salud mediante la ampliación de la cobertura del sistema nacional, aprovechando debidamente la medicina tradicional, así como apoyar la nutrición de los indígenas mediante programas de alimentación, en especial para la población infantil.
IV. Mokualtlalis intlachialis maseual altepemej iuan kalixpa inemilispa iuikpa nelkuali tlachixtosej iuan tlamauisosej, ika tekiyotl tlen uelis kiasisej sentika tlapaleuilistli iuan tlatsaktok tlapaleuilistli, iuikpa uelis mochantisej iuan kikualtlalisej ininchan, noso momiakilis tlapaleuilistli tlen nochi tlanekilistli.	IV. Mejorar las condiciones de las comunidades indígenas y de sus espacios para la convivencia y recreación, mediante acciones que faciliten el acceso al financiamiento público y privado para la construcción y mejoramiento de vivienda, así como ampliar la cobertura de los servicios sociales básicos.
V. Mochiuas matlatskikan siuamej ipan yolchikaualistli, ika tlapaleuilistli tekiyotl tlen tlaeliltilistli, momanauis intlakayo, momaktilisej tlapaleuilistli tlen ika uelis momachtisej iuan tlatskisej ipan tlanauatikayotl tlen ika mochanchiua maseual kalpolmej.	V. Propiciar la incorporación de las mujeres indígenas al desarrollo, mediante el apoyo a los proyectos productivos, la protección de su salud, el otorgamiento de estímulos para favorecer su educación y su participación en la toma de decisiones relacionadas con la vida comunitaria.
VI. Moueyilis matlatl tlajtoltlamatilistli tlen ika uelis mosennechikosej kalpomej, ika inon motlapos iuan mopatlauas ueyojtli iuan uejka tlanojnotsalisltli. Mokualtlalis tlajtoli tlen ika uelis kikouasej, kitekiuisej iuan kimokuitlauisej tlajatoltlamatilistli, ken moijtoua ipan itechpoui tlajtoltlanauatili.	VI. Extender la red de comunicaciones que permita la integración de las comunidades, mediante la construcción y ampliación de vías de comunicación y telecomunicación. Establecer condiciones para que los pueblos y las comunidades indígenas puedan adquirir, operar y administrar medios de comunicación, en los términos que las leyes de la materia determinen.
VII. Mopaleuis tekiyotl tlaeliltislitli iuan yolchikaualistli tlen maseual kalpolmej, ika tlachiualistli tlen ika uelis kiasisej achi miak tomin tlaxtlauili, motekiuis tlapaleuilistli iuikpa sentika tlapaleuistli iuan tlatsaktok tlapaleuilistli tlen ika moyolitis tekitl, motekiuis yankuik tlachiuali iuikpa momiakilis tlaeliltilistli, iuan noijki iuikpa uelis kiasisej tlachiuali tlen tlaeliltilistli iuan tlanamakalistli.	VII. Apoyar las actividades productivas y el desarrollo sustentable de las comunidades indígenas mediante acciones que permitan alcanzar la suficiencia de sus ingresos económicos, la aplicación de estímulos para las inversiones públicas y privadas que propicien la creación de empleos, la incorporación de tecnologías para incrementar su propia capacidad productiva, así como para asegurar el acceso equitativo a los sistemas de abasto y comercialización.
VIII. Moyektlalis altepetlanauatili tlen ika mopaleuisej tlakamej tlen kisteua ipan maseual altepemej, ipan tochan tlalnantsin noso ipan seyok tlaltlanauatiloyan, ika tlachiuali tlen moneltokas tlen tekitl intechpoui miltekitinij, mokualtlalis intlakayo siuamej, mopaleuis tekiyotl tlamachtilistli iuan tlakualistli tlen konemej, telpokamej iuan ichpokamej sejkano ontekitinij; mosentlachilis mamotlepanita tlen intechpoui iuan moixnestis tlaiyokalistli.	VIII. Establecer políticas sociales para proteger a los migrantes de los pueblos indígenas, tanto en el territorio nacional como en el extranjero, mediante acciones para garantizar los derechos laborales de los jornaleros agrícolas; mejorar las condiciones de salud de las mujeres; apoyar con programas especiales de educación y nutrición a niños y jóvenes de familias migrantes; velar por el respeto de sus derechos humanos y promover la difusión de sus culturas.
IX. Motlakakilisej maseual altepemej keman moijkuilos Sentekiyotl Yolchikaualistli iuan tlen tlaltlanauatiloyan, iuan altpetlanauatiloyan, noso mamoamatlali tlen yeuan motlatlanilia iuan motlanekiliaj.	IX. Consultar a los pueblos indígenas en la elaboración del plan nacional de desarrollo y de los estatales y municipales y, en su caso, incorporar las recomendaciones y propuestas que realicen.
Iuikpa uelis monelchiuas tlajtoli tlen monekilia ipan inin tlakuilolpamitl, in Tlajtokan tlen Ueyi Nechikolistli Tlanauatiloyan, tlajtoltekichiuanij tlen tlaltlanauatianej iuan altepetlanauatianej, kampa yeuantin tlanauatiaj, kiixtlalisej kenijki motekiuis tomin tlen ika uelis kichiuasej tlanauatili ipan tomin tlayeyekoli tlen yeuantin kikualitasej, iuan noijki moijtos kenijki tlapaleuisej iuan tlamokuitlauisej kalpolmej keman motekiuis in tomin tlayeyekoli.	Para garantizar el cumplimiento de las obligaciones señaladas en este apartado, la cámara de diputados del congreso de la unión, las legislaturas de las entidades federativas y los ayuntamientos, en el ámbito de sus respectivas competencias, establecerán las partidas especificas destinadas al cumplimiento de estas obligaciones en los presupuestos de egresos que aprueben, así como las formas y procedimientos para que las comunidades participen en el ejercicio y vigilancia de las mismas.
San amo motlajtlakauis maseual tlatechpouilistli tlen nikan moijtoa, kalpolmej iuan altepemej tlen yeuantin, nochi oksekintin kalpolmej tlen maseual nesij, noijki mopialisej seja tlatechpouilistli ken moijtoua ipan tlajtoltlanauatili.	Sin perjuicio de los derechos aquí establecidos a favor de los indígenas, sus comunidades y pueblos, toda comunidad equiparable a aquellos tendrá en lo conducente los mismos derechos tal y como lo establezca la ley.
Tlen 39 Tlanauatijkayotl. In Anauak Sentlanauatikayotl mani ipan ineluayotipa altepeyotl. Nochi chikaualistli tlen altepechantli moyolitia ipan altepeyotl iuan mochantlalia tlen ika mopaleuis yeua altepeyotl. In altepeyotl nochi tonatij kipia xitlauak itechpoui kixoleuas noso kipatlas tlen kenijki mochiua tlanauatijkayotl.	Artículo 39. la Soberanía Nacional reside esencial y originariamente en el pueblo. Todo poder público dimana del pueblo y se instituye para beneficio de este. El pueblo tiene en todo tiempo el inalienable derecho de alterar o modificar la forma de su gobierno.
"Padre nuestro,
que estás en el cielo,
santificado sea tu Nombre;
venga a nosotros tu reino;
hágase tu voluntad
en la tierra como en el cielo."	"Totahtsin,
in ilwikatl timoyetstika,
ma yektenewalo in motokatsin;
ma walaw in motlatokayotsin;
ma chiwalo in tlaltikpak
motlanekilitsin iw in ilwikak."
Danos hoy nuestro pan de cada día;	In totlaxkalmomostla totechmoneki ma axkan xitechmomakili;
"perdona nuestras ofensas,
como también nosotros perdonamos
a los que nos ofenden;"	 iwan xitechmapopolwili in totlatlakol, in iw tikintlapopolwiah in techtlatlakalwiah;
no nos dejes caer en la tentación,	iwan makamo xitechmotlalkawili inik amo ipan tiwetske ipan teneyeyehkoltilistli,
y líbranos del mal.	ma xi techmomakixtili in iwikpa in amo kwali.
Amén.	Ma iw mochiwa.
Nuestro Señor Jesucristo, El Nazareno.	Motekwtsin Jesutsin, In Nasaretsin.
Por esos tiempos casi nadie quería mandar a sus hijos a la escuela porque no podían vestir bien. Vivían sucios en sus casas, andrajosos; andaban jugando los niños por la calle o andaban por las milpas.	Ica ipan in tonaltin amoca huel oquinequi aquihuicaz in ipilhuan ompa tlamachtilcalco ipampa ahueli quintzotzomatizque achi cualtzin. Inchachan onemia tzotzoyoquez, tzatzapaltiquez; zan ompa omahuiltitinemia pipiltoton ca ipan otli nozo oyatinemia ica cuecuentla.
En una casa había una buena señorita que sabía leer, leer papeles. Enseñaba en su casa. Los padres querían que se les enseñara a leer a sus hijos; pagaban un real por cada niño o niña que estudiaba.	Ipan ce calli ometztaya ce ciahuapilli omomachtiaya momachtitzinoz, mopohuiz amatl. Omotemach¬tiliaya ipan icaltzin. Tatatzin ahquehuan oquinequia ixtlapohuizque ipilhuan; otlaxtlahualoya ce tomin cada piltzintli nozo ciahuaconetl momachtiz.
Se llamaba Mariquita; su marido se llamaba Mauro Melo. También enseñaba a los niños. En esa escuela fue donde aprendí a conocer una, dos, tres letras y también a escribir y a leer.	Itocatzin Malintzin; tenamic itocatzin Mauro Melo. Noihqui oquinmomachtiliaya pipilton. Itic on tlamachtilcalli onohtiti niquiixmatiz ce, ome, yeyi letra ihuan ihqui cuiloz noihqui nitlapoaz.
Mi madre después me platicó cómo yo lloraba porque quería entrar a la escuela; todavía no había muchos profesores.	Nonantzin nechmononochiliaya quename onichocaya ipampa oninequia nicalaquiz tlamachtilcalco; ye yiman on ayemo huel miaque oyeya temachtiquez.
Mi madre me tomaba de la mano e íbamos a la plaza. Pero, como pasábamos frente a la casa [de la profesora] veíamos cómo jugaban los niños o a veces estudiaban. Yo lloraba; quería entrar para estudiar también. Lloraba mucho porque quería saber lo que decían los papeles, los escritos. No era yo grande; tenía siete años. Mi madre no quería que yo fuera a la escuela porque era chica y me fueran a tirar al suelo los niños, pero mi padre y mi madre, como lloraba, no tardaron en llevarme con la señorita que daba clases.	Nonantzin noechmomatechanilitaya ihuan otitaya tianquizco. Ihuan ican otipanoya ixpan on calli otitaya omahuiltiaya cocone nozo quema nian omomachtiaya. Nehuatl onichocaya; onicnequia nicalaquiz noihqui nomachtiz. Nichocaya coza ipampa onicnequia nicmatiz tlan quitoa amame, inon tlacuiloltin. Ayemo huel nihueyi; onicpiaya chicome xihuitl. Nonantzin amo omonequiltiaya niaz itic tlamachtilcalli ipampa nitepiton ihuan nechtlacalizque occequi coconetoton. Can nozo amo huecuh nonantzin ihuan notatzin ica nichoca onechhuicaque itlauhtzinco cihuapilli in omotemachtiliaya.
Cuando ya era grandecita mis padres me llevaron a la escuela grande, no querían recibirme para instruirme.	Ye yiman ye nihuehueiton notatzitzihuan onechmiquilique ompa tlahueimachtilcalco. Amo oquinequia nechanazque ompa nomachtiz.
“A esta pequeña niña”, dijo el inspector, “llévenla a su casa y en un año me la traen. Entonces ya la recibiremos; que crezca más, si no, estará llorando aquí”.	«Tetepiton cihuatontli», oquito in inspector, «xicuicacan namochan ce xihuitl ipan in nancualicazque. Ye tamechanilizque ma ocuachi huepahui. Tlacamo oncuan chocataz.»
“Bueno señor”, le dijo mi madre al inspector, “le suplico mucho que se quede mi niña. Le gusta mucho aprender. Ya conoce algunas letras”.	Nonantzin oquimolhuilic inspector, «Mahuiztic tlacatl, huel miac nimitzmotlatlauhtilia ma mocahua nocihuanton. Coza quitequipachoa momachtiz. Ye quiixmati tepitzin letras».
«¿Cómo va a saber?», dijo el inspector. «Si todavía está muy pequeña; todavía no es grande. Ustedes quieren que reciba a su hija. Oigan: si recibimos a su hija, la dejarán ustedes aquí a las ocho. Tocarán la campana y tendrá que estar adentro o donde estén todas las niñas; y vendrán ustedes por ella a mediodía. Otra vez vendrá a las dos y media. No piensen que sólo en la mañana va a estudiar. ¿Qué dicen? ¿Aceptan o no?»	«¡Quenin quimatiz?» oquito inspector, «Tepitzin cihuanton; ayemo huel hueyi. Namehuan nanquinequi namechaniliz namoconeuh. Xiccaquican: tla ticanazque cihuanton nanquicahuaquihue nican ipan chicueyi tlamachotiloni. Tziliniz tepoztli yeyez calitic campa nochtin cocone yezque; ihuan nancanaquihue tlaco tonalli. Occepa hualaz ipan ome huan tlaco tlamachotiloni teotlac. Amo siquitocan zan yehuatzinco momachtiz. ¡Tlen nanquitoa? ¿Nanquicelia nozo amo?»
Mi padre y mi madre dijeron que así se haría. «Vendremos a dejarla temprano y vendremos por ella para que coma, y luego vendrá a estudiar en la tarde».	Notatzin ica nonantzin omitlahuique ma iqui mochihuaz. «Ticahuaquihue yehuatzinco ihuan ticanaquihue ican tlacuatiuh, ihuan zatepa hualaz momachtiz ica teotlac.»
«¿Cuánto se va a pagar?», preguntaron mis padres.	Omotlatlanique notatzitzihuan, “¿Quexquich titlaxtlahuazque”»
«Nada», contestó el inspector. «No pagarán las criaturas para que se les enseñe».	«Amitla», otlananquili inspector, «amo tlaxtlahuazque cocone ican momachtizque».
Luego preguntaron: «¿Qué traeremos para que escriba, qué libro, que más pide usted que traiga mi hija mañana?».	Ye yiman on otlatlanihuac, «¿tlen ticualicazque ica tlacuiloz, tlen amochtli, tlen ocuache timotlaniz oncuan on moztla cualicaz noconeuh?»
Así contestó el inspector: «No, no se pagará nada. Si es cierto que tiene tantas ganas de aprender, aquí le daremos papel y todo lo que necesite. Aquí le enseñaremos a leer; en la tarde le enseñaremos a coser, a cortar y muchas otras cosas curiosas. Eso sí, que venga limpia su ropa, su cabeza, que no traiga animalitos y que traiga zapatos; que no venga descalza. Así aprenderán a vivir bien cuando sean grandes».	Iqui otlananquili inspector: «Amo, amo tlacualicaz. Tla melahuac quitequipachoz momachtiz oncuan ticmacazque amatl ihuan nochi tlen quinequiz. Oncuan quinmatizque; ica teotlac quititizque tlatzomaz, tlatetequiz ihuan occequi tlamahuizoltin. Zan yehuatl hualaz chipahuac in tzotzoma, chipahuac itzonteco. Amoca cualicaz yolcatl icuac ticpan ihuan tlacahhuiz; amo hualaz sin cahtli. Iqui in motitizque quename nemizque icuac ye huehueyi».
Pasó el año y pasé a lo que se llama segundo año de enseñanza.	Opanoc xihuitl ihuan onipano quilhuia ome xihpa nomachtiz.
Así es como me dieron instrucción mis padres.	Iqui in notatzitzihuan onechmomachtilique.
Por el año llamado de 1908 entré a la escuela llamada Concepción Arenal de Milpa Alta [que estaba en una casa del pueblo]. Allí vivían en el primer piso el director y el inspector. El director se llamaba Lucio Tapia y el inspector se apellidaba Guzmán.	Ica ipan xihuitl mitoa novecientos chicueyi onicalac ipan tlamachtilcalco itoca Concepción Arenal Momochco Malacateticpac. Ompa chantiaya tlacpac director ihuan inspector. Director itoca Lucio Tapia ihuan inspector itzonquizca Guzmán.
Abrían temprano la escuela. Cuando yo comencé a estudiar los maestros llegaban allá a Milpa Alta como a las nueve o nueve y media de la mañana. Poco tiempo después se decidió que, ya que este plantel era grande, se les arreglaran cuartos donde pudieran vivir los maestros. Cada uno tenía su cuarto.	Oncuan on nochipa cualcan oquitlapoaya tlamachtilcalli. Icuac onipeuh momachtia temachtiquez oyecoya ompa Milpa Alta. Queman chicnahui tlamachotiloni huan tlaco. Zan nohuian omonemili quename inin tlamachtilcalli hueyi oyeya, oquitlauhqueque quen caltin can chantizque temachticahuan. Xexelihca oyeya.
Ya para entonces todos los niños tenían que estar frente a la escuela como a las siete y media de la mañana, cuando sonaba la campana. Entonces los niños corrían todos para tomar su lugar.	Ye timan tica in nochtin piltzitzintin oquipiaya tlan yezque ixpan tlamachtilcalli quemen chicome huan tlaco tlamachotiloni yehuatzinco, icuac otzilinia in tepoztli. Ye yiman on piltzitzintin otzicuinia nochtin cacizque in lugar.
Para entonces los padres estaban contentos y decían: «Así muy pronto llegarán los niños. Si aprenden bien, buenos hijos saldrán de esta escuela».	Ye yiman tica on tatzitzintin opaquia ihuan oquitoaya: «Iquin in zan cualcan hualazque cocone. Quema cualli momachtizque, cuacualli cocone quizazque ipan inin tlamachtilcalli».
Y se decían los padres: «¿No querrá usted que su hijo o su hija enseñe aquí también?»	Ihuan omolhuiaya tatatzitzintin: «Amo timonequiltiz motelpochtzin nozo mochpochtzin oncan temachtiz noihqui?»
“¡Cómo no!” decían, “¡me gustaría!”	«Quenin amo», molhuiaya «zan huel nechpactiz».
Estudiábamos dos veces al día y la que no llevara sus zapatos brillosos, sin bañarse, o sin peinar, la mandaban a la escuela de los muchachos. Allí les lavaban los pies, las peinaban y le hacían brillar los zapatos con lo que llamaban “bola”. Con un trapo los brillaban hasta que estuvieran brillantes. Así es como nos enseñaron a vivir correctamente. Daba vergüenza que los muchachos le peinaran y lavaran a una la cabeza. Las llevaban a la escuela de Concepción Arenal otra vez.	Otomachtiaya ocpac cemilhuitl ihuan ahquen amo cuicaya icac quename on petlantaz, nozo amo mamohuic, amo motzocuazhui, oquititlania ipan tlamachtilcalli can momachtia pipiltoton. Ompa pipiltoton oquixopapacaya, oquitzocuazhuiaya ihuan icahhuan noihqui oquintlapalhuiaya ica quicuitaya bola. Ica ce tatapatli oquipopoaya can quizaz tlapetlanalli. Iqui on ica otechtitique quename ica tinemizque. Ican tepinauhtin quename pipiltoton otetzcuazhuiaya oteamohuiaya. Tla yoquinmamahuique oquinhuicaya occepa tlamachtilcalco Concepción Arenal.
Era el año de 1908 y así nos enseñaban a vivir bien.	Yeca ipan novecientos chicueyi iqui in otechtitiaya que tinemizque cualli.
Allí en Milpa Alta no había agua. Iban algunas personas a lavar a Nochcalco. También a San Gregorio Atlapulco otros a Tecomil. Así es como nos tenían limpios. El padre se levantaba como a la cuatro de la mañana y con un caballo y un cuero, se iba a traer el agua allá a Nochacalco. Esa agua era para tomar y cocinar. Así se resolvieron los trabajos.	Ompa Milpa Alta amo onyeya atl. Ohuilaloya Nochcalco tlapacoz cequi tlacatl. Ohuilaloya noihqui tlapacoz ica San Gregorio Atlapulco; occequi ompa Tecomic. Iqui on otechpiaya tichichipahuaquez. tatatzintli omehuaya queman nahui tlamachotiloni ica ce cahuayo huan cuitlaxtli oyaya quicuizque atl ompa Nochcalco. Yehuatl on otiquia ihuan ica otlacualchihualoya. Opapanoc iqui in tlen omotetequipano.
De nuestras maestras ninguna quería quedarse a residir en Milpa Alta. No había casas que rentarles; no había pan, no había quién sirviera (de criado). Ninguno de los maestros se quería quedar, así es que, tal como se había pensado, alquilaron casas. Para entonces comenzaron a quedarse en Milpa Alta (los maestros).	Totlamachtilcahuan amoca huel oquinequia mocahuazchantiz Momochco Malacateticpac. Amo onyeya caltin quintetlaquehuizque; amo inyeya pantzin. Nian aca tlatepalehuiz. Nochtin temachtiquez amo oquinequia mocahuazque. Oncuan on omonemili oquintlaquehque caltin. Ye yiman on opehque mocahque temachtiquez Momochco Malacateticpac.
Decidieron el prefecto y el inspector apresar a todos los hombres, tuvieran hijos o no. Los hombres tendrían que estar encerrados para que los interrogaran y ellos contestaran con toda sinceridad. Les preguntaban si iban a enviar a sus hijos a la escuela. El que contestaba que sí mandaría a sus hijos a la escuela lo soltaban. Y a los que decían que no tenía hijos los encerraban un mes y les preguntaban: “¿Cuántos niños tienen ustedes? ¿¡Los van ha mandar a la escuela?” Algunos respondían: “No tengo hijos, sólo hermanos y hermanas,” “ Pues dile a tu padre que los mande a la escuela! ¡No tendrán que pagar nada!”	Oquinemilique prefecto ihuan inspector quintzatzacuazque nochtlaca quipiaz nozo amo quipiaz iconeuh. Quipiaz tlen tzauhtaz queniman quitlatolanazque huan tlananquiliz tlen quitoa iyolo. Quintitlaniz tla quintitlanizque inpilhuan tlamachtilcalco. Aquen otlanaquiliaya quititlaniz ipilhuan tlamachtilcalco oquincacahuaya. Ihuan tlen oquitoaya amo oquipiaya tlen tzauhtazque ce metztli. Ihuan oquimilhuiaya: «¿Quezqui cocone nanquimpia? Nanquititlanizque tlamachtilcalco?» Occequi oquitoaya: «Amo nicpia cocone; zan nocnehuan.» «¡Can nozo xiquilhui motatzin ma quintitlani tlamachtilcalco! ¡Amotla tlaxtlahuazque!».
En esa época era Secretario de Educación el señor Justo Sierra. Daba libros para que estudiaran los niños y papel para que escribieran. No se compraba nada [para la escuela en esos tiempos]; todo lo daban en la escuela y sólo exigían que fueran limpios los niños. Los de primer año, segundo, tercero y cuarto sólo aprendían a contar y cantar. Los de quinto y sexto estudiábamos en libros, y si eran niñas se les enseñaba a cortar, bordar ropa bonita en la máquina. También nos enseñaban a dibujar en papel. Nuestros maestros también nos enseñaban a hacer pan.	Ye yiman tica on ometztac tlatihuani Justo Sierra, Secretario Educación. Omotemaquiliaya amoxtin ica momachtizque cocone ihuan amatl ica tlacuilozque. Amotla omocoaya. Nochi on oquitemacaya ompa tlamachtilcalco ihuan zan yehuatl yazque chichipatique cocone. Tlen primer año, segundo, tercero ihuan cuarto zan yehuatl omomachtiaya amatl ihuan tla cihuantoton oquinmachtiaya tlatetequizque, tlacuicuilozque itech amame. Noihqui otechnonotzaya totemachticauh quenin ica omochihuaya pantzin.
Allá en mi casa, en Milpa alta, los hombres trabajan y las mujeres hacen tortillas, hacen comida. Así es que cuando llega el hombre y tiene hambre, toda la comida lo está esperando. Así es como viven los de mi pueblo.	Ompa nochan, momochko malakatetikpak, tlaka tekiti iuan siuame tlaxkaloa, tlakualchiua. Onkuan on yekos tlakatl ye mayana nochi tlakuali sa tekichia. Ijki in ika nemia nochantlaka.
Mientras los hombres van a trabajar, también las mujeres se van a comprar a la plaza, adonde se vende carne, frijoles, maíz –todo lo necesario– leña, carbón, fruta, todo lo que se les ofrece a las mujeres en casa. Cuando vuelven las mujeres de la plaza ponen la comida en la lumbre y se cuece. Traen el agua en unos jarros grandes o en botes, y si ya llegó el marido corre la mujer a comprar el pulque.	Noka yaue tlaka tekitiske siuame noijki tlakoa ompa tiankisko kampa monamaka nakatl, yetl, tlaoli –nochi tlan monekis- kuauitl, tekoli, xochikuali: nochi in itech moneki siuame ipan kali. Yomokuepke siuame tiankistli kitlipantlalia tlakuali iuan uisi. Kisaka atsintli ika se tikaxalotin noso teposkaxtin iuan tla youala tenamik, tsikuini siuatontli kikoas neutli.
Así que, maestro, le voy a contar unas palabras acerca de mi pueblo y de mi vida.	Iki in, temachtiani, niau nimitstlanonotsas inin tlatoli itech naltepeu iuan nonemilis.
Momochco Malacatetípac mi pueblo, se llama Milpa Alta en español, o la Asunción Milpa alta, y está entre los cerros del Cuauhtzín y del Teuhtli.	Momochko Malakatetikpak, naltepeu, itokan Milpa Alta kaxtilankopa noso Asunción Milpa Alta iuan intsalan tetepeme Kuautisn iuan Teutli.
Mi padre, mi madre, hablaban bien el mexicano y el español. […]	Nota, nonan, kuali otlatoaya maseualkopa iuan kastilankopa. En esa época, no como ahora, nadie se avergonzaba de hablar el mexicano. Muchos no sabían el castellano.
[…]	 He visto mucho malo y mucho bueno en mi vida, pero lo que más me gustó fue cuando yo era chiquita y comencé a ir a la escuela.
Pero primero voy a contar unas palabras acerca de mi padre. Cuando yo era pequeña mi padre no trabajaba mucho, sólo raspaba sus magueyes en el campo y así hacía el pulque con sus doce magueyitos. Como no éramos muchos hijos entonces se podía vivir con el dinero del pulque. Por esos tiempos costaba el litro de pulque tres centavos. Por esos tiempos no se usaba la palabra “litro” como hoy. Para medir había cuartillos, medios cuartillos y cuartos de cuartillo.	Achtopa inin tlatoli itech notatsin niau nitlanonotsas. Ikuak neua nitepiton notatsin ayemo uel amotekitiliaya. San yeuatl omotlakichiliaya kuentla matlaktli uan ome metoton uan omotlachikiliaya onkuan on mochiuas neutli. Ika ayemo miak tepiluan oyeya kuali opanoaloya ika neutomin. Ipan on tonaltin ipatiu se litro neutli yeyi centavo. Ika ipan tika on amo omopiaya litros ke axan. Ika tlatamachiualo iman tika on oyeya almontin tlakualmon iuan cuarterón.
Con eso podían vivir mi padre y mi madre. Luego vinieron más hijos. Éramos muchos. Ya éramos seis hermanas. Para entonces mi padre trabajaba más porque éramos muchos en la casa. Mi padre tenía que trabajar en el campo. Ya llevaba el arado, ya trabajaba con el azadón. También había veces que trabajaba con la talacha; con ésta arrancaba los magueyes, y el azadón era para sembrar el maíz. Así vivió mi padre. Por eso fue que nunca nos faltó que comer, que beber; ni tampoco nos faltó nunca ropa.	Ika on omopanoltiaya notatsin iuan nonantsin. San niman oyekoke tepiluan. Ye timiaktin. Iuan nokneuan otiyeya tichikuasentin. Ye yiman tika on okuache notatsin omotekiliaya okuache ipampa ye timiaktin otiyeya ipan kali. Notatsin omopiliaya tlen motekitilis tekuekuentla. Yomokiliaya arado, yomotekitiliaya tlaltepostli. Noijki kemanian omotekitiliaya ika tlalacha; inon ika metsontekikixtilo iuan tlaltepostli ika omotokaya tlaoli. Ijki on ik omonemiti notatsin. Onkuan on aik otechpolo tlan tikuaske, tlen tikiske; nian noijki totsotsoma aik otechpolo.
Entonces mi padre cogía trabajo por destajo, como se dice, y para poder trabajar bien se levantaba a las tres de la mañana; se iba a cultivar el maíz o a limpiar los magueyes, o a sacar troncos de maguey. Para las nueve de la mañana mi padre ya había terminado su tarea; luego llegaba a la casa; ya estaba el almuerzo. Almorzaba con frijoles de olla, o molito con carne y su pulquito.	Ye yiman on notatsin omaniliaya tekitl ke inon mitoa ika estajo. Iuan onkuan kuali motekitilis omeutsinoaya yeyi jora uatsinko; nikas motlatlaluis tlaoli, noso mepopouis, noso mometsontekixtilis. Iuan ikuak asis chijnaui tlatepostlamachotiloni notatsin yomosenkauili se tarea; san niman omaxtitiaya kalitik; yekan almasal. Omamasaluiaya ika ye moli noso chilatl ika nakatl iuan omitiaya ineneutsin.
Y luego se echaba encima el mecapal y el hacha. Llevaba comida para dos días, también pulque para dos días, y agua para poder hervir café allá en el monte. Mientras se ponía a rajar la leña, dejaba armado el horno para que se hiciera el carbón. Cuando ya estaba funcionando el horno, se quedaba allí una noche y un día. Porque tenia que ver si se encendía o se apagaba el horno. Porque sabía trabajar el horno; se prende y se apaga; y si se apagaba, mi padre lo volvía a encender.	San niman omaniliaya mekapali iuan hacha. Omikiliaya itakatl para ome tonali, neutli noijki ome tonali, atsintli ika moposonilis ikafetsin ompa kuautla. Noka moxexeluiaya kuauitl onkuan on metekechilis horno onkuan kisas tekoli. Iman yometekelik omokautsinoaya se youali iuan semiluitl. Onkuan on mojtilis tla otikuik noso oseu horno. Ipampa iki on kimati kichiuas horno¸tlikui iuan seui; iuan tla oseuia notatsin omomektlikechiliaya.
Aquí se cuenta, se ordena, cómo hace poco, milagrosamente se apareció la perfecta virgen santa María Madre de Dios, nuestra reina, allá en el Tepeyac, de renombre Guadalupe.	Nikan mopoua, motekpana, in kenin yankuikan ueytlamauisoltika monexiti in senkiska ichpochtli Sankta Maria Dios Inantsin tosiuapilatokatsin, in onkan Tepeyakak, moteneua Guadalupe.
Primero se hizo ver de un indito, su nombre Juan Diego; y después se apareció su Preciosa Imagen delante del reciente Obispo Don Fray Juan de Zumárraga.	Akattopa kimottititsino se maseualtsintli itoka Juan Diego; Au santenpan monexiti in Itlasoixiptlatsin in ixpan yankuikan Obispo Don Fray Juan de Zumarraga.
Diez años después de conquistada la Ciudad de México, cuando ya estaban depuestas las flechas, los escudos, cuando por todas partes había paz en los pueblos,	Ye yu matlak xiuitl in opeualok in atl in tepetl Mexiko, in ye omoman in mitl in chimali, in ye nouian ontlamatkamani in auakan in tepeuakan.
así como brotó ya verdece, ya abre su corola la fe, el conocimiento de Aquel por quien se vive: el verdadero Dios.	in maka san ye opeu, ye xotla, ye kueponi in tlaneltokilistli, in iximachokatsin in Ipalnemouani, neli Teotl Dios.
En aquella sazón, el año 1531, a los pocos días del mes de diciembre, sucedió que había un indito, un pobre hombre del pueblo,	In uel ijkuak in ipan xiuitl mil y kinientos y treinta y uno, kin iu ikeskiluiok in metstli Disiembre mochiu: onkatka se maseualtsintli iknotlapalsintli.
su nombre era Juan Diego, según se dice, vecino de Cuauhtitlan,	itoka katka Juan Diego, iu mitoa ompa chane Kuautitlan,
y en las cosas de Dios, en todo pertenecía a Tlatilolco.	au in ika Teoyotl , ok mochompa pouia in Tlatilolko.
Era sábado, muy de madrugada, venía en pos de Dios y de sus mandatos.	Au Sabado katka, uel ok youatsinko, kiualtepotstokaya in Teoyotl iuan in inetititlanis.
Y al llegar cerca del cerrito llamado Tepeyac ya amanecía.	Au in asiko in inauak tepetsintli in itokayokan Tepeyakak, ye tlatlalchipaua,
Oyó cantar sobre el cerrito, como el canto de muchos pájaros finos; al cesar sus voces, como que les respondía el cerro, sobremanera suaves, deleitosos, sus cantos sobrepujaban al del coyoltototl y del tzinitzcan y al de otros pájaros finos.	konkak in ikpak tepetsintli kuikoa, yukin nepapan tlasototome kuika; kakauani in intoski, iukin kinanankilia tepetl, uel senka teyolkima, teuelamachti in inkuik, kisenpanauia in koyoltototl, in tsinitskan iuan in oksekin tlasototome ik kuika.
Se detuvo a ver Juan Diego. Se dijo: ¿Por ventura soy digno, soy merecedor de lo que oigo? ¿Quizá nomás lo estoy soñando? ¿Quizá solamente lo veo como entre sueños?	Kimotstimokets in Juan Diego, kimolui: “—¿Kuix noluil, kuix nomaseual in ye nikkaki ¿Aso san niktemiki ¿Aso san nikkochitleua
¿Dónde estoy? ¿Dónde me veo? ¿Acaso allá donde dejaron dicho los antiguos nuestros antepasados, nuestros abuelos: en la tierra de las flores, en la tierra del maíz, de nuestra carne, de nuestro sustento; acaso en la tierra celestial?	¿Kanin ye nika, kanin ye ninotta ¿Kuix ye onkan in kitoteuake ueuetke tachtouan tokokoluan, in xochitlalpan in tonakatlalpan, kuix ye onkan in iluikatlalpan “
Hacia allá estaba viendo, arriba del cerrillo, del lado de donde sale el sol, de donde procedía el precioso canto celestial.	Ompa on itstikaya in ikpak tepetsintli in tonatiu ikisayampa, in ompa ualkistia in iluikatlasokuikatl.
Y cuando cesó de pronto el canto, cuando dejó de oírse, entonces oyó que lo llamaban, de arriba del cerrillo, le decían: “Juanito, Juan Dieguito”.	Au in oyuseutikis in kuikatl, in omokaktimoman in yeekikaki ualnotsalo in ikpak tepetsintli, kiluia: “—Juantsin, Juan Diegotsin”.
Luego se atrevió a ir a donde lo llamaban; ninguna turbación pasaba en su corazón ni ninguna cosa lo alteraba, antes bien se sentía alegre y contento por todo extremo; fue a subir al cerrillo para ir a ver de dónde lo llamaban.	Niman san yemotlapaloa inik ompa yas in kanin notsalo, aken mochiua in iyolo, manose itla ik misauia, yese uel paki uelamachtia; kitlekauita in tepetsintli ompa itstia in kampa ualnotsalok,
Y cuando llegó a la cumbre del cerrillo, cuando lo vio una Doncella que allí estaba de pie,	au in ye asitiu in ikpak tepetsintli, in ye okimottili se Siuapili onkan moketsinotikak,
lo llamó para que fuera cerca de Ella.	kiualmonochili inik onyas in inauaktsinko.
Y cuando llegó frente a Ella mucho admiró en qué manera sobre toda ponderación aventajaba su perfecta grandeza:	Au in oyuasito in ixpantsinko, senka kimomauisalui in kenin uelasenpanauia in ik senkiska mauistikatsintli;
su vestido relucía como el sol, como que reverberaba,	in itlakentsin yukin tonatiu ik motonameyotia, inik pepetlaka;
y la piedra, el risco en el que estaba de pie, como que lanzaba rayos;	au in tetl in texkali in ik itech moketsa, inik kimina;
el resplandor de Ella como preciosas piedras, como ajorca (todo lo más bello) parecía	in itlanexyotsin yuki in tlasochalchiuitl, makistli, in ik nesi;
la tierra como que relumbraba con los resplandores del arco iris en la niebla.	yukin ayaukosamalokuekueyoka in tlali.
Y los mezquites y nopales y las demás hierbecillas que allí se suelen dar, parecían como esmeraldas. Como turquesa aparecía su follaje. Y su tronco, sus espinas, sus aguates, relucían como el oro.	Au in miskitl, in nopali iuan oksekin nepapan xiutototin onkan mochichiuani yukin ketsalistli, yuki in teoxiuitl in iatlapalo nesi. Au in ikuauyo, in iuitsyo, in iauayo yuki in kostikteokuitatl ik pepetlaka.
En su presencia se postró. Escuchó su aliento, su palabra, que era extremadamente glorificadora, sumamente afable, como de quien lo atraía y estimaba mucho.	Ixpantsinko mopechtekak, kikak in iyotsin in itlatoltsin in uel senka teuelamachti in uel tekpiltik yuki in kimokokonauilia, kimotlatlasotilia.
Le dijo:—”escucha , hijo mío el menor, Juanito. ¿a donde te diriges? “	Kimoluili: “—Tlaxikkaki noxokoyou Juantsin, kampa in timouika “
Y él le contestó:—”Mi Señora, Reina, Muchachita mía, allá llegaré, a tu casita de México Tlatilolco, a seguir las cosas de Dios que nos dan, que nos enseñan quienes son las imágenes de Nuestro Señor: nuestros Sacerdotes. “	Au in yeuatl kimonankilili: “—Notekuiyoe Siuapile, Nochpochtsine, ka ompa nonasis mochantsinko Mexiko Tlatilolko, nokontepotstoka in teoyotl, in techmomakilia, in techmomachtilia in ixiptlauan in Tlakatl in Totekuiyo, in toteopixkauan”.
En seguida, con esto dialoga con él, le descubre su preciosa voluntad;	Niman ye ik kimononochilia, kimixpantilia in itlasotlanekilistsin,
le dice: “sábelo, ten por cierto hijo mío el mas pequeño, que yo soy la perfecta siempre virgen santa María, madre del verdaderísimo dios por quien se vive, el creador de las personas, el dueño de la cercanía y de la inmediación, el dueño del cielo, el dueño de la tierra. mucho quiero, mucho deseo que aquí me levanten mi casita sagrada	kimoluilia: “Maxikmatti, ma uel yu ye in moyolo, noxokoyou, ka neuatl in nisenkiska semikak Ichpochtli Sankta Maria, in Inantsin in uel neli Teotl Dios, in Ipalnemouani, in Teyokoyani, in Tloke Nauake, in Iluikaua, in Tlaltikpake. Uel nikneki, senka nikeleuia inik nikan nechkechiliske noteokaltsin,
en donde lo mostrare, lo ensalzare al ponerlo de manifiesto:	in onkan niknextis, nikpantlasas.
lo daré a las gentes en todo mi amor personal, en mi mirada compasiva, en mi auxilio, en mi salvación:	Niktemakas in ixkich notetlasotlalis, noteiknoitlalis, in notepaleuilis, in notemanauilis,
porque yo en verdad soy vuestra madre compasiva,	Ka nel neuatl in namoiknouakanantsin,
tuya y de todos los hombres que en esta tierra están en uno,	in teuatl iuan in ixkichtin in ik nikan tlalpan ansepantlaka,
y de las demás variadas estirpes de hombres, mis amadores, los que a mi clamen, los que me busquen, los que confíen en mi,	iuan in oksekin nepapantlaka, notetlasotlakauan, in notech motsatsilia, in nechtemoa, in notech motemachilia,
porque allí les escuchare su llanto, su tristeza, para remediar, para curar todas sus diferentes penas, sus miserias, sus dolores.	ka onkan nikinkakilis in inchokis, in intlaokol, inik nikyektilis nikpatis in ixkich nepapan innetolinilis, intoneuis, inchichinakilis.
y para realizar lo que pretende mi compasiva mirada misericordiosa, anda al palacio del obispo de México, y le dirás como yo te envió, para que le descubras como mucho deseo que aquí me provea de una casa, me erija en el llano mi templo; todo le contaras, cuanto has visto y admirado, y lo que has oído.	Au inik uelneltis in niknemilia in noteiknoittalis ma xiau in ompa in itekpanchan in Mexiko Obispo, au tikiluis in kenin neua nimitstitlani inik tikixpantis in kenin uel senka nikeleuia inik nikan nechkalti, nechkechili in ipan in tlalmantli noteokal; uel moch tikpouilis in ixkich in otikittak, otikmauiso, iuan in tlein otikkak.
y ten por seguro que mucho lo agradeceré y lo pagaré,	Au ma yu ye in moyolo ka uel niktlasokamattis, au ka nikixtlauas
que por ello te enriqueceré, te glorificaré;	ka ik nimitskuiltonos, nimitstlamachtis,
y mucho de allí merecerás con que yo retribuya tu cansancio, tu servicio con que vas a solicitar el asunto al que te envió.	iuan miek onkan tikmaseuaik nikkuepkayotiin mosiauilis, in motekipanoliin ik tiknemilitiu in tlein nimitstitlani.
ya has oído, hijo mío el menor, mi aliento, mi palabra; anda, haz lo que este de tu parte”.	Okayeotikkak, noxokoyou, in niiyo, in notlatol; ma ximouikatiu, ma ixkich motlapal xikmochiuili.”
E inmediatamente en su presencia se postró; le dijo:—”Señora mía, Niña, ya voy a realizar tu venerable aliento, tu venerable palabra; por ahora de Ti me aparto, yo, tu pobre indito”.	Au niman ik ixpantsinko onmopechtekak, kimoluili: “—Notekuiyoe, Siuapile, ka ye niyau inik nikyektilis in miiyotsin in motlatoltsin, ma ok nimitsnotlalkauili in nimoknomaseual”.
Luego vino a bajar para poner en obra su encomienda: vino a encontrar la calzada, viene derecho a México.	Niman ik ualtemok inik kineltilitiu in inelitlanis: konnamikiko in kuepotli, ualamelaua Mexiko.
Cuando vino a llegar al interior de la ciudad, luego fue derecho al palacio del Obispo, que muy recientemente había llegado, Gobernante Sacerdote; su nombre era D. Fray Juan de Zumárraga, Sacerdote de San Francisco.	In oasiko itik altepetl, niman ik tlamelau in itekpanchantsinko Obispo, in uel yankuikan ualmouikak Teopixkatlatoani, itokatsin katka D. Fray Juan de Sumarraga, San Fransisko Teopixki.
Y en cuanto llegó, luego hace el intento de verlo, les ruega a sus servidores, a sus ayudantes, que vayan a decírselo;	Au in oasito niman ik moyeyekoa inik kimottilis, kintlatlautia in itetlayekoltikauan in itlanenkauan, inik konittotiue;
después de pasado largo rato vinieron a llamarlo, cuando mandó el Señor Obispo que entrara.	ye achi uekautika in konnotsako, in ye omotlanauatili in Tlatouani Obispo inik kalakis.
Y en cuanto entró, luego ante él se arrodilló, se postró, luego ya le descubre, le cuenta el precioso aliento, la preciosa palabra de la Reina del Cielo, su mensaje, y también le dice todo lo que admiró, lo que vió, lo que oyó.	Au in onkalak niman ixpantsinko motlankuakets, mopechtekak, niman ye ik kimixpantilia kimopouilia in iiyotsin in itlatoltsin Iluikak Siuapili in inetitlanis: noiuan kimoluilia in ixkich okimauiso, in okittak, in okikak.
Y habiendo escuchado toda su narración, su mensaje, como que no mucho lo tuvo por cierto,	Au in okikak in mochi itlatol, inetitlanis, yukin amo senka monelchiutsino,
le respondió, le dijo: “Hijo mío, otra vez vendrás, aun con calma te oiré, bien aun desde el principio miraré, consideraré la razón por la que has venido, tu voluntad, tu deseo”.	kimonankili, kimoluili: “—Nopiltse ma okseppa tiualas, ok iuian nimitskakis, uel ok itsinekan nikittas, niknemilis in tlein ik otiuala in motlanekilis, in motlaeleuilis”.
Salió; venía triste porque no se realizó de inmediato su encargo.	Ualkis; tlaokoxtiuits, inik amo niman oneltik in inetitlanis.
Luego se volvió, al terminar el día, luego de allá se vino derecho a la cumbre del cerrillo,	Niman ualmokuep is sa ye ikuak ipan semiluitl; niman onka ualamelau in ikpak tepetsintli,
y tuvo la dicha de encontrar a la Reina del Cielo: allí cabalmente donde la primera vez se le apareció, lo estaba esperando.	au ipantsinko asito in Iluikak Siuapili, is san ye onkan in kanin akattopa kimottili, kimochialitika.
Y en cuanto la vio, ante Ella se postró, se arrojó por tierra, le dijo:	Au in oyukimottili, ixpantsinko mopechtekak, motlalchitlas, kimoluili:
“Patroncita, Señora, Reina, Hija mía la más pequeña, mi Muchachita, ya fui a donde me mandaste a cumplir tu amable aliento, tu amable palabra; aunque difícilmente entré a donde es el lugar del Gobernante Sacerdote, lo vi, ante él expuse tu aliento, tu palabra, como me lo mandaste.	“—Notekuiyoe, Tlakatle, Chiuapile, Noxokoyoue, Nochpochtsine, ka oniuia in ompa otinechmotitlanili, ka onikneltilito in miiyotsin in motlatoltsin; masiui in ouiuitika in onikalak in ompa iyeyan in teopixkatlatoani, ka onikittak, ka oixpan niktlali in miiyotsin in motlaltotsin in yu otinechmonanauatili,
Me recibió amablemente y lo escuchó perfectamente pero, por lo que me respondió, como que no lo entendió, no lo tiene por cierto.	onechpakkaseli, au okiyekkak; yese inik onechnankili yukin amo iyolo omasik, amo monelchiua.
Me dijo: Otra vez vendrás; aun con calma te escucharé, bien aun desde el principio veré por lo que has venido, tu deseo, tu voluntad.	—Onechilui: —Okseppa tiualas, ok iuiyan nimitskakis, uel ok itsinekan nikittas in tlein otiuala, motlayeleuilis, motlanekilis.
Bien en ello miré, según me respondió, que piensa que tu casa que quieres que te hagan aquí, tal vez yo nada más lo invento, o que tal vez no es de tus labios;	—Uel itech onikittak in yu onechnankili ka momatti in moteokaltsin tikmonekiltia mitsmochiuililiske nikan, aso san neuatl nikyoyokoya, akasomo motenkopatsinko;
mucho te suplico, Señora mía, Reina, Muchachita mía, que a alguno de los nobles, estimados, que sea conocido, respetado, honrado, le en—cargues que conduzca, que lleve tu amable aliento, tu amable palabra para que le crean.	ka senka nimitsnotlatlautilia Notekuiyoe, Siuapile, Nochpochtsine, manoso aka seme in tlasopipiltin, in iximacho, in ixtilo, in mauistilo, itech xikmokauili in kitkis in kiuikas in miiyotsin in motlaltoltsin inik neltokos.
Porque en verdad yo soy un hombre del campo, soy mecapal, soy perihuela, soy cola, soy ala; yo mismo necesito ser conducido, llevado a cuestas, no es lugar de mi andar ni de mi detenerme allá a donde me envías, Virgencita mía, Hija mía menor, Señora, Niña;	Ka nel niknotlapaltsintli, ka nimekapali, ka nikakaxtli, ka nikuitlapili, ka natlapali, ka nitko ka nimamaloni, kamo nonenemian, kamo noneketsayan in ompa tinechmiualia, Nochpochtsine, Noxokoyoue, Tlakatle. Siuapile.
por favor dispénsame: afligiré con pena tu rostro, tu corazón; iré a caer en tu enojo, en tu disgusto, Señora Dueña mía”.	Ma xinechmotlapopoluili niktekipachos in mixtsin in moyolotsin, ipan nias, ipan niuetsis in mosomatsin in mokualantsin, Tlakatle, Notekuiyoe”.
Le respondió la Perfecta Virgen, digna de honra y veneración:	Kimonankilili in Senkiska Mauisichpochtsintli:
“escucha, el mas pequeño de mis hijos, ten por cierto que no son escasos mis servidores, mis mensajeros, a quienes encargue que lleven mi aliento, mi palabra, para que efectúen mi voluntad;	“Tlaxikkaki noxokoyou ma uel yu ye in moyolo kamo tlasotin in notetlayekoltikauan in notititlanuan, in uel intech nikkauas in kitkiske in niiyo in notlatol, in kineltiliske in notlanekilis:
Pero es muy necesario que tú, personalmente vayas, ruegues, que por tu intercesión se realice, se lleve a efecto mi querer, mi voluntad.	yese uel yu moneki inik uel teuatl ik tinemis, ipan titlatos, uel momatika neltis, mochiuas, in nosialis, in notlanekilis.
Y mucho te ruego, hijo mío el menor, y con rigor te mando, que otra vez vayas mañana a ver al obispo.	Au uel nimitstlatlautia noxokoyou, iuan nimitstlakuaunauatia ka uel okseppa tias in mostla tikittatiu in Obispo.
Y de mi parte hazle saber, hazle oír mi querer, mi voluntad, para que realice, haga mi templo que le pido.	Au nopampa xiknemachti, uel yu xikkakiti in nosialis, in notlanekilis, inik kineltilis inik kichiuas noteokal nikitlanilia.
Y bien, de nuevo dile de que modo yo, personalmente, la siempre virgen santa María, yo, que soy la madre de dios, te mando”.	Iuan uel okseppa xikilui in kenin uel neuatl nisemikak Ichpochtli Sankta Maria in niinantsin Teotl Dios in ompa nimitstitlani”.
Juan Diego, por su parte, le respondió, le dijo:—”Señora mía, Reina, Muchachita mía, que no angustie yo con pena tu rostro, tu corazón; con todo gusto iré a poner por obra tu aliento, tu palabra; de ninguna manera lo dejaré de hacer, ni estimo por molesto el camino.	Au in Juan Diego kimonankilili kimoluili: —”Notekuiyoe, Siuapile, Nochpochtsine, makamo niktekipacho in mixtsin in moyolotsin, ka uel nosenyolokakopa nonyas, nokonneltilitiu in miiyotsin in motlatoltsin ka niman amo niknokakaualtia, manose niktekokokamatti in ojtli.
Iré a poner en obra tu voluntad, pero tal vez no seré oído, y si fuere oído quizás no seré creído.	Ka nonyas nokonchiuatiu in motlanekilistsin, san uel ye in aso kamo niyekkakos; in tlanose ye onikakok akasomo nineltokos.
Mañana en la tarde, cuando se meta el sol, vendré a devolver a tu palabra, a tu aliento, lo que me responda el Gobernante Sacerdote.	Ka tel mostla ye teotlak in ye onkalaki tonatiu nikkuepakiu in miiyotsin in motlatoltsin in tlein ik nechnankilis in Teopixkatlatoani;
Ya me despido de Ti respetuosamente, Hija mía la más pequeña, Jovencita, Señora, Niña mía, descansa otro poquito”.	Ka ye nimitsnotlalkauilia, Noxokoyoue, Nochpochtsine, Tlakatle, Siuapile, ma ok ximoseuitsino”.
Y luego se fue él a su casa a descansar.	Au niman ik in ya ichan moseuito.
Al día siguiente, Domingo, bien todavía en la nochecilla, todo aún estaba oscuro, de allá salió, de su casa, se vino derecho a Tlatilolco, vino a saber lo que pertenece a Dios y a ser contado en lista; luego para ver al Señor Obispo.	Au in imostlayok Domingo, uel ok youatsinko tlatlayouatok, ompa ualkis in ichan ualamelau in Tlatilolko, kimattiuits in teoyotl iuan inik tepoualos: niman ye inik kittas Teopixkatlatoani.
Y a eso de las diez fue cuando ya estuvo preparado: se había oído Misa y se había nombrado lista y se había dispersado la multitud.	Au aso ya ipan matlaktli jora in onesenkaualok inik omokak Misa, iuan otepoualok, in ualxin in ixkich maseuali.
Y Juan Diego luego fue al palacio del Señor Obispo.	Au in yeuatl Juan Diego niman ik ya in itekpanchantsinko in Tlatoani Obispo.
Y en cuanto llegó hizo toda la lucha por verlo, y con mucho trabajo otra vez lo vió;	Au in oasito ixkich itlapal okichiu inik okimottilis; au uel ouitika in okseppa kimottili;
a sus pies se hincó, lloró, se puso triste al hablarle, al descubrirle la palabra, el aliento de la Reina del Cielo,	ikxitlantsiko motlankuakets, choka, tlaokoya in ik kimononochilia, in ik kimixpantilia in iiyotsin in itlatoltsin in Iluikak Siuapili,
que ojalá fuera creída la embajada, la voluntad de la Perfecta Virgen, de hacerle, de erigirle su casita sagrada, en donde había dicho, en donde la quería.	inik aso sanen neltokos in inetitlanis in itlanekilistsin Senkiska Ichpochtli, inik kimochiuililiske, inik kimokechililiske in iteokaltsin in kanin omotlateneuili in kanin kimonekiltia.
Y el Gobernante Obispo muchísimas cosas le preguntó, le investigó, para poder cerciorarse, dónde la había visto, cómo era Ella, todo absolutamente se lo contó al Señor Obispo.	Au in Tlatoani Obispo uel miak tlamantli inik kitlatlani, kitlatemoli, inik uel iyolo masis, kampa in kimottili, kenamekatsintli; uel moch kipouilili in Tlatoani Obispo.
Y aunque todo absolutamente se lo declaró, y en cada cosa vió, admiró que aparecía con toda claridad que Ella era la Perfecta Virgen, la Amable, Maravillosa Madre de Nuestro Salvador Nuestro Señor Jesucristo,	Au masiui in uel moch kimomelauilili in yukatsintli, iuan in ixkich okittak, okimauiso inka uel yu nesi ka Yeuatsin is Senkiska Ichpochtsintli in Itlasomauisnantsin in Totemakixtikatsin Totekuiyo Jesukristo;
sin embargo, no luego se realizó	yese amo niman ik omonelchiu.
Dijo que no sólo por su palabra, su petición se haría, se realizaría lo que él pedía,	Kito ka amo san ika itlatol itlaitlanilis mochiuas moneltilis in tlein kitlani,
que era muy necesaria alguna otra señal para poder ser creído cómo a él lo enviaba la Reina del Cielo en persona.	Ka uel ok itla ineska moneki inik uel neltokos in kenin uel Yeuatsin kimotitlanilia in Iluikak Sipuapili.
Tan pronto como lo oyó Juan Diego, le dijo al Obispo:	Au in oyukikak in Juan Diego kimoluili in Obispo:
“Señor Gobernante, considera cuál será la señal que pides, porque luego iré a pedírsela a la Reina del Cielo que me envió”.	“Tlakatle, Tlatoanie, ma xikmottili katleuatl yes in ineska tikmitlanilia ka niman niyas nikitlanililitiu in Iluikak Siuapili onechualmotitlanili.”
Y habiendo visto el Obispo que ratificaba, que en nada vacilaba ni dudaba, luego lo despacha.	Au in okittak in Obispo ka uel monelchiua ka niman atle ik meleltia, motsotsona, niman ik kiua.
Y en cuanto se viene, luego les manda a algunos de los de su casa en los que tenía absoluta confianza, que le vinieran siguiendo, que bien lo observaran a dónde iba, a quién veía, con quien hablaba.	Au in ye uits, niman ik kinmonauatili keski in ichantlaka, in uel intech motlakaneki, kiualtepotstokaske, uel kipipiaske kampa in yau, iuan akin konitta konnotsa.
Y así se hizo. Y Juan Diego luego se vino derecho. Siguió la calzada.	Tel iu mochiu. Au in Juan Diego niman ik ualamelau, kitokak in kuepotli.
Y los que lo seguían, donde sale la barranca cerca del Tepeyac, en el puente de madera lo vinieron a perder. Y aunque por todas partes buscaron, ya por ninguna lo vieron.	Au in kiualtepotstokaya onkan atlautli kisa inauak Tepeyakak, quaupantitlan kipoloko, manel ok nouian tlatemoke aokkan kittake.
Y así se volvieron. No sólo porque con ello se fastidiaron grandemente, sino también porque les impidió su intento, los hizo enojar.	San yu ualmokuepke, amo saniyo in ik omoxixiutlatito, noiuan ik okimelelti okinkualankakuiti.
Así le fueron a contar al Señor Obispo, le metieron en la cabeza que no le creyera, le dijeron cómo nomás le contaba mentiras, que nada más inventaba lo que venía a decirle, o que sólo soñaba o imaginaba lo que le decía, lo que le pedía.	Yu kinonotsato in Tlatoani Obispo, kitlauelalilike inik amo kineltokas, kiluike inik san konmostlakauilia, san kipipiki in tlein kiualmoluilia, anose san okitemik, san okikochitleu in tlein kimoluilia in tlein kimitlanililia;
Y bien así lo determinaron que si otra vez venía, regresaba, allí lo agarrarían, y fuertemente lo castigarían, para que ya no volviera a decir mentiras ni a alborotar a la gente.	Au uel yu kimoluike intla okseppa ualas, mokuepas, onkan kitsitskiske, iuan chikauak kitlatsakuiltiske inik aokmo seppa istlakatis, tekuamanas.
Entre tanto, Juan Diego estaba con la Santísima Virgen, diciéndole la respuesta que traía del Señor Obispo;	In okixkichika Juan Diego kakta ixpantsinko Semikak Ichpochtsintli, kiluiaya itenankililis in kitkilito itenkopa Uey Teopixkatlatoani;
la que, oída por la Señora, le dijo:	in oyukimokakilti in Tlatokasiuapili kilui:
“bien esta, hijito mío, volverás aquí mañana para que lleves al obispo la señal que te ha pedido;	“—Ka ye kuali, ka ye yuki, noxokoyou, nikan mostla okseppa tiualas inik tikitkilitiu Uey Teopixki in tlaneltilistli in neskayotl in mitstlatlanilia;
con eso te creerá y acerca de esto ya no dudará ni de ti sospechará;	Ik niman mitstlatolkakilis, iuan itechpa ayokik mitschikomattis, nion motech chikoyolouas;
y sábete, hijito mío, que yo te pagaré tu cuidado y el trabajo y cansancio que por mí has impendido;	Iuan ma uel yu ye in moyolo, noxokoyu, ka nimitstlaxtlauis monetlakuitlauilis, motlatekipanolis mosiammikilis, in nopampa titlapopolotok.
ea, vete ahora; que mañana aquí te aguardo”.	Tlakuele, notelpotsin, ka tel mostla ye nikan nimitsonchixtos”.
Y al día siguiente, lunes, cuando debía llevar Juan Diego alguna señal para ser creído, ya no volvió.	In imostlayok Lunes in ikuak kiuikaskia in Juan Diego in itla ineska inik neltokos aokmo oualmokuep:
Porque cuando fue a llegar a su casa, a un su tío, de nombre Juan Bernardino, se le había asentado la enfermedad, estaba muy grave.	Ye ika in ikuak asito in ichan, se itla, itoka Juan Bernardino, oitechmotlali in kokolistli, uel tlanautok.
Aun fue a llamarle al médico, aun hizo por él, pero ya no era tiempo, ya estaba muy grave.	Ok kitisinochilito, ok ipan tlato, yese aokmo inman, ye uel otlanau:
Y cuando anocheció, le rogó su tío que cuando aún fuere de madrugada, cuando aún estuviere oscuro, saliera hacia acá, viniera a llamar a Tlatilolco algún Sacerdote para que fuera a confesarlo, para que fuera a prepararlo,	Au in ye youak, kitlatlauti in itla in ok youatsinko, ok tlatlayouatok ualkisas, kimonochilikiu in onkan Tlatilolko seme in teopixke inik mouikas, kimoyolkuitilitiu, iuan kimosenkauilitiu,
porque estaba seguro de que ya era el tiempo, ya el lugar de morir, porque ya no se levantaría, ya no se curaría.	ye ika ka uel yuka in iyolo ka ye inman, ka ye onkan inik mikis ka aok meuas aokmo patis.
Y el martes, siendo todavía mucho muy de noche, de allá vino a salir, de su casa, Juan Diego, a llamar el Sacerdote a Tlatilolco,	Au in Martes, uel ok tlatlayouatok in ompa ualkis ichan in Juan Diego in kimonochilis teopixki in ompa Tlatilolko,
y cuando ya acertó a llegar al lado del cerrito terminación de la sierra, al pie, donde sale el camino, de la parte en que el sol se mete, en donde antes él saliera, dijo:	au in ye asitiuits inauak tepetsintli Tepeyakak in ikxitlan kistika ojtli tonatiu ikalakiampa, in onkan yeppa kisani, kito:
“Si me voy derecho por el camino, no vaya a ser que me vea esta Señora y seguro, como antes, me detendrá para que le lleve la señal al gobernante eclesiástico como me lo mandó;	“Intla san nikmelaua ojtli, manen nechualmottiliti is Siuapili, ka yeppa nechmotsikaluis inik nik uikilis tlaneskayotl in teopixkatlatoani, in yu onechmonauatili;
que primero nos deje nuestra tribulación; que antes yo llame de prisa al sacerdote religioso mi tío no hace más que aguardarlo”	ma ok techkaua in tonetekipachol, ma ok nik nonochilitiuetsi in teopixki motolinia, in notlatsin amo sa kimochialitok”.
En seguida le dio la vuelta al cerro, subió por en medio y de ahí, atravesando, hacia la parte oriental fue a salir, para rápido ir a llegar a México, para que no lo detuviera la Reina del Cielo.	Niman ik kontlakolui in tepetl; itsalan ontlekok yenepa sentlapal, tonatiu ikisayampa kisato, inik isiuka asitiu Mexiko inik amo kimotsikaluis in Iluikak Siuapili,
Piensa que por donde dio la vuelta no lo podrá ver la que perfectamente a todas partes está mirando.	in momatti ka in ompa in otlakolo ka auel kimottilis in uel nouiampa motstilitika.
La vio cómo vino a bajar de sobre el cerro, y que de allí lo había estado mirando, de donde antes lo veía.	Kittak kenin ualmotemoui ikpak in tepetsintli ompa ualmotstilitok in ompa yeppa konmottiliani.
Le vino a salir al encuentro a un lado del cerro, le vino a atajar los pasos; le dijo:	Konmonamikiliko in inakastlan tepetl, konmotsakuililiko, kimoluili:
“¿Qué pasa, el mas pequeño de mis hijos? ¿A dónde vas, a dónde te diriges? “	“—Aux noxokoyou, kampa in tiyau; Kampa in titstiu “
Y él, ¿tal vez un poco se apenó, o quizá se avergonzó? ¿o tal vez de ello se espantó, se puso temeroso?	Au in yeuatl kuix achi ik melelma Kuix nose pinauak kuix nose ik misaui, momauti
En su presencia se postró, la saludó, le dijo:	Ixpantsinko mopechtekak, kimotlapalui, kimoluili:
“Mi Jovencita, Hija mía la más pequeña, Niña mía, ojalá que estés contenta; ¿cómo amaneciste? ¿Acaso sientes bien tu amado cuerpecito, Señora mía, Niña mía?	“Nochpochtsine, Noxokoyoue, Siuapile, maximopakiltitie, ken otimixtonalti Kuix tikmouelmachitia in motlasonakayotsin, Notekuiyoe, Nopiltsinsine
Con pena angustiaré tu rostro, tu corazón: te hago saber, Muchachita mía, que está muy grave un servidor tuyo, tío mío.	Niktekipachos in mixtsin in moyolotsin: ma xikmomachiltitsino, Nochpochtsine, ka uelanautok se momaseualtsin notla,
Una gran enfermedad se le ha asentado, seguro que pronto va a morir de ella.	Uey kokolistli in itech omotlali; ka yeppa ik momikilis.
Y ahora iré de prisa a tu casita de México, a llamar a alguno de los amados de Nuestro Señor, de nuestros sacerdotes, para que vaya a confesarlo y a prepararlo,	Au ok nonisiutiu in mochantsinko Mexiko, nokonnonochilis seme in itlasouan Totekuiyo in toteopixkauan, konmoyolkuitilitiu, iuan konmosenkauilitiu,
porque en realidad para ello nacimos, los que vinimos a esperar el trabajo de nuestra muerte.	ka nel ye inik otitlakatke in tikchiako in tomikistekiu.
Mas, si voy a llevarlo a efecto, luego aquí otra vez volveré para ir a llevar tu aliento, tu palabra, Señora, Jovencita mía.	Au intla onokonneltilito, ka niman nikan okseppa niualmokuepas, inik nonyas nokonitkis in miiyotsin in motlatoltsin, Tlakate Nochpochtsine.
Te ruego me perdones, tenme todavía un poco de paciencia, porque con ello no te engaño, Hija mía la menor, Niña mía, mañana sin falta vendré a toda prisa”.	Ma xinechmotlapopoluili, ma ok ixkich xinechmopakkaijiyouilti kamo ik nimitsnokeluia, Noxokoyoue, Nopiltsine, ka niman mostla nikistiuetsikiu.”
En cuanto oyó las razones de Juan Diego, le respondió la Piadosa Perfecta Virgen:	Au in oyukimokakiti itlatol in Juan Diego kimonankili in Iknouakasenkiskaichpochtsintli:
“Escucha, ponlo en tu corazón, hijo mío el menor, que no es nada lo que te espantó, lo que te afligió; que no se perturbe tu rostro, tu corazón; no temas esta enfermedad ni ninguna otra enfermedad ni cosa punzante, aflictiva.	“Maxikkaki, ma uel yu ye in moyolo, noxokoyou, maka tle tlein mitsmauti, mitstekipacho, makamo ken mochiua in mix in moyolo makamo xikimakasi in kokolistli, manose ok itla kokolistli, kokok teopouki.
¿No estoy aquí yo, que soy tu madre? ¿No estas bajo mi sombra y resguardo? ¿No soy yo la fuente de tu alegría? ¿No estas en el hueco de mi manto, en el cruce de mis brazos? ¿Tienes necesidad de alguna otra cosa?	¿Kuix amo nikan nika nimonantsin ¿Kuix amo noseualotitlan, nekauyotitlan in tika ¿Kuix amo neuatl in nimopakkayelis Kuix amo nokuixanko nomamaluasko in tika ¿Kuix ok itla in motech moneki
Que ninguna otra cosa te aflija, te perturbe; que no te apriete con pena la enfermedad de tu tío, porque de ella no morirá por ahora, ten por cierto que ya esta bueno”.	Makamo ok itla mitstekipacho, mitsamana, makamo mitstekipacho in ikokolis motlatsin, kamo ik mikis in axkan itechka; ma uel yu ye in moyolo ka ye opatik”.
(Y luego en aquel mismo momento sanó su tío, como después se supo).	(Au ka niman uel ikuak patik in itlatsin in yu santepan machistik.)
Y Juan Diego, cuando oyó la amable palabra, el amable aliento de la Reina del Cielo, muchísimo con ello se consoló, bien con ello se apaciguó su corazón,	Au in Juan Diego in oyukikak in iiyotsin in itlatoltsin in Iluikak Siuapili, uel senka ik omoyolali, uel ik pachiu in iyolo.
y le suplicó que inmediatamente lo mandara a ver al Gobernante Obispo, a llevarle algo de señal, de comprobación, para que creyera.	Au kimotlatlautili inik ma sa ye kimotitlanili inik kittatiu in Tlatoani Obispo in kitkilis itla ineska, in ineltika, inik kineltokas.
Y la Reina Celestial luego le mandó que subiera a la cumbre del cerrillo, donde antes la veía;	Au in Iluikak Siuapili niman ik kimonauatili inik ontlekos in ikpak tepetsintli, in onkan kanin yeppa konmottiliaya;
Le dijo:—”Sube, hijo mío el menor, a la cumbre del cerrillo, a donde me viste y te di órdenes;	Kimoluili: “—Xitleko, noxokoyou in ikpak in tepetsintli, au in kanin otinechittak iuan onimitsnanauati;
allí verás que hay variadas flores: córtalas, reúnelas, ponlas todas juntas; luego baja aquí; tráelas aquí, a mi presencia”.	Onkan tikittas onok nepapan xochitl, xikteteki, xiknechiko, xiksentlali, ninam xik—ualtemoui, nikan nixpan xik—ualuika”.
Y Juan Diego luego subió al cerrillo,	Au in Juan Diego niman ik kitlekaui in tepetsintli.
y cuando llegó a la cumbre, mucho admiró cuantas había, florecidas, abiertas sus corolas, flores las más variadas, bellas y hermosas, cuando todavía no era su tiempo;	Au in oasito ikpak, senka kimauiso in ixkich onok, xotlatok, kuepontok in nepapan kaxtilan tlasoxochitl, in ayamo imochiuyan,
porque deveras que en aquella sazón arreciaba el hielo;	ka nel uel ikuak in motlapaltilia issetl;
estaban difundiendo un olor suavísimo, como perlas preciosas, como llenas de rocío nocturno.	uel senka auiaxtok, iuki in tlasoepyolotli inik youalauachyotok;
Luego comenzó a cortarlas, todas las juntó, las puso en el hueco de su tilma.	Niman ik peu in kiteteki, uel moch kinechiko, kikuixanten.
Por cierto que en la cumbre del cerrito no era lugar en que se dieran ningunas flores, sólo abundan los riscos, abrojos, espinas; nopales, mezquites,	Au in onkan ikpak tepetsintli, ka niman atle xochitl in imochiuyan, ka texkala, netsola, uiuitstla, nopala, miskitla;
y si acaso algunas hierbecillas se solían dar, entonces era el mes de diciembre, en que todo lo come, lo destruye el hielo.	au intla xiutotontin mochichiuani, in ikuak in ipan Metstli Disiembre, ka moch kikua kipopoloua issetl,
Y en seguida vino a bajar, vino a traerle a la Niña Celestial las diferentes flores que había ido a cortar,	Au ka niman ik ualtemok, kiualmotkilili in Iluikak Siuapili in nepapan xochitl okitetekito,
y cuando las vio, con sus venerables manos las tomó;	au in oyukimottili, imatikatsinko konmokuili;
luego otra vez se las vino a poner todas juntas en el hueco de su ayate, le dijo:	niman ye okseppa ikuexanko kiualmotemili kimoluili:
“Mi hijito menor, estas diversas flores son la prueba, la señal que llevarás al Obispo;	“—Noxokoyou, inin nepapan xochitl yeuatl in tlaneltilis in neskayotl in tik—uikilis in Obispo.
de mi parte le dirás que vea en ellas mi deseo, y que por ello realice mi querer, mi voluntad.	Nopampa tikiluis ma ik kitta in notlanekilis iuan ik kineltilis in notlanekilis, in nosialis.
Y tú… , tú que eres mi mensajero… , en ti absolutamente se deposita la confianza;	Au in teuatl in tinotitlan ka uel motech netlakanekoni;
y mucho te mando con rigor que nada más a solas, en la presencia del Obispo extiendas tu ayate y le enseñes lo que llevas.	Au uel nimitstlakuaunauatia san uel isel ixpan Obispo tiksouas in motilma, iuan tiknextilis in tlein tik—uika:
Y le contarás todo puntualmente, le dirás que te mandé que subieras a la cumbre del cerrito a cortar flores, y cada cosa que viste y admiraste,	Au uel moch tikpouilis, tikiluis in kenin onimitsnauati inik titlekos in ikpak tepetsintli in tiktetekitiu xochitl, iuan in ixkich otikittak, otimauiso,
para que puedas convencer al gobernante sacerdote, para que luego ponga lo que está de su parte para que se haga, se levante mi templo que le he pedido”.	inik uel tikyoloyeuas in Teopixkatlatoani inik niman ipan tlatos inik mochiuas, moketsas in noteokal onikitlanili.”
Y en cuanto le dió su mandato la Celestial Reina, vino a tomar la calzada, viene derecho a México, ya viene contento.	Au in okonmonanauatili in Iluikak Siuapili kiualtokak in kuepotli Mexiko ualmelaua, ye paktiuits.
Ya así viene sosegado su corazón, porque vendrá a salir bien, lo llevará perfectamente.	Ye yu yetiuits in iyolo ka yekkisakiu, kiyekitkis.
Mucho viene cuidando lo que está en el hueco de su vestidura, no vaya a ser que algo tire;	Uel kimokuitlauitiuits in tlein ikuixanko yetiuits in manen itla kimakau;
viene disfrutando del aroma de las diversas preciosas flores.	kimotlamachtitiuits in iauiaka in nepapan tlasoxochitl.
Cuando vino a llegar al palacio del Obispo, lo fueron a encontrar el portero y los demás servidores del Sacerdote gobernante,	In oasiko itekpanchan Obispo konnamikito in ikalpixkau iuan oksekin itlanenkauan in Tlatokateopixki.
y les suplicó que le dijeran cómo deseaba verlo, pero ninguno quiso, fingían que no le entendían, o tal vez porque aún estaba muy oscuro.	Au kintlatlauti inik ma kimoluilikan in kenin kimottilisneki, yese ayak seme kinek, amo konmokakkaneke aso ye inik uel ok youatsinko.
o tal vez porque ya lo conocían que nomás los molestaba, los importunaba,	au anose inik ye kiximatti san kintepachoa inik imixtlan pilkatinemi,
y ya les habían contado sus compañeros, los que lo fueron a perder de vista cuando lo fueron siguiendo.	iuan ye okinonotske in imikniuan in kipoloto in iquak kitepotstokake.
Durante muchísimo rato estuvo esperando la razón.	Uel uekautika in otlatolchixtikatka.
Y cuando vieron que por muchísimo rato estuvo allí, de pie, cabizbajo, sin hacer nada, por si era llamado, y como que algo traía, lo llevaba en el hueco de su tilma; luego pues, se le acercaron para ver qué traía y desengañarse.	Au in okittake ye uel uekautika in onkan ikak, motololtitikak, tlatenmatikak in aso notsalos, iuan in iukinma itla kiualitki, kikuixanotikak; niman ye ik itech onasike inik kittiliske tlein kiuikats inik inyolo pachiuis.
Y cuando vió Juan Diego que de ningún modo podía ocultarles lo que llevaba y que por eso lo molestarían, lo empujarían o tal vez lo aporrearían, un poquito les vino a mostrar que eran flores.	Au in okittak in Juan Diego ka niman auel kintlatilis in tlein kiuikats, ka ik kitoliniske kitotopeuaske nose ik kimiktiske, tepiton kiualnexti ka xochitl.
Y cuando vieron que todas eran finas, variadas flores y que no era tiempo entonces de que se dieran, las admiraron muy mucho, lo frescas que estaban, lo abiertas que tenían sus corolas, lo bien que olían, lo bien que parecían.	Au in yukittake ka moch kaxtilan nepapan xochitl iuan in kamo imochiuyan in ikuak, uel senka kimauisoke, iuan in kenin uel senka seltik, inik kueponki, inik auiak, inik mauistik.
Y quisieron coger y sacar unas cuantas;	Au keleuike inik keskitetl konanaske, kikixtiliske;
tres veces sucedió que se atrevieron a cogerlas, pero de ningún modo pudieron hacerlo,	au uel expa mochiuki inik motlapaloke konkuiskia; niman auel mochiuki,
porque cuando hacían el intento ya no podían ver las flores, sino que, a modo de pintadas, o bordadas, o cosidas en la tilma las veían.	yeika in ikuak kiitskiskia aokmo uel xochitl in kittaya, san yukima tlakuiloli, nose tlamachtli, nose tlatsontli in itech kittaya tilmatli.
Inmediatamente fueron a decirle al Gobernante Obispo lo que habían visto,	Niman ik kimoluilito in Tlatoani Obispo in tlein okittake;
cómo deseaba verlo el indito que otras veces había venido, y que ya hacía muchísimo rato que estaba allí aguardando el permiso, porque quería verlo.	iuan in kenin kimottilisneki in maseualtsintli ye iskipa ualau, iuan in ye uel uekau in ye ik aso onka tlatlatolchixtok inik kimottilisneki.
Y el Gobernante Obispo, en cuanto lo oyó, dió en la cuenta de que aquello era la prueba para convencerlo, para poner en obra lo que solicitaba el hombrecito.	Au in Tlatoani Obispo in oyu kimokakiti, niman ipan ya in iyolotsin ka yeuatl in ineltika inik iyolotsin masis, inik kimoneltililis in tlein ik nemi tlakatsintli.
En seguida dió orden de que pasara a verlo.	Niman motlanauatili inik niman kalakis, kimottilis.
Y habiendo entrado, en su presencia se postró, como ya antes lo había hecho.	Au in okalak ixpantsinko mopechtekak, in yu yeppa kichiuani;
Y de nuevo le contó lo que había visto, admirado, y su mensaje.	au okseppa kimotlapouilili in ixkich okittak in okimauiso iuan in inetitlanis.
Le dijo:—”Señor mío, Gobernante, ya hice, ya llevé a cabo según me mandaste;	Kimoluili: “—Notekuiyoe, Tlatoanie, ka ye onikchiu, ka ye onikneltili in yu otinechmonauatili,
así fui a decirle a la Señora mi Ama, la Niña Celestial, Santa María, la Amada Madre de Dios, que pedías una prueba para poder creerme, para que le hicieras su casita sagrada, en donde te la pedía que la levantaras;	ka uel yu oniknoluilito in Tlakatl in Notekuiyo in Iluikak Siuapili Santa Maria in Teotl Dios Itlasonantsin, in tikmitlania in tlaneskayotl inik uel tinechmoneltokitis, inik tikmochiuililis in iteokaltsin in onkan mitsmitlanililia, tikmokechilis;
y también le dije que te había dado mi palabra de venir a traerte alguna señal, alguna prueba de su voluntad, como me lo encargaste.	au ka uel yu oniknoluili in onimitsnomakili in notlatol inik nimitsualnouikilis in itla ineska in ineltika in itlanekilistsin inik nomak otikmokauili.
Y escuchó bien tu aliento, tu palabra, y recibió con agrado tu petición de la señal, de la prueba, para que se haga, se verifique su amada voluntad.	Au ka okiuelmokakiti in miiyotsin in motlatoltsin; au okimopakkaselili in tikmitlania in itla ineska, ineltika, inik mochiuas moneltilis in itlanekilistsin.
Y ahora, cuando era todavía de noche, me mandó para que otra vez viniera a verte;	Au ye in in axkan ok youatsinko onechmonauatili inik oksepa nimitsnottilikiu;
y le pedí la prueba para ser creído, según había dicho que me la daría, e inmediatamente lo cumplió.	au oniknitlanilili in itla ineska inik nineltokos, in yu onechmoluili nechmomakilis, au ka san niman okimoneltilili.
Y me mandó a la cumbre del cerrito en donde antes yo la había visto, para que allí cortara diversas rosas de Castilla.	Au onechmiuali in ikpak tepetsintli in kanin yeppa nokonnottiliani inik ompa niktetekitiu in nepapan Kaxtilan xochitl.
Y cuando las fui a cortar, se las fui a llevar allá abajo;	Au in oniktekito, onichualnouikilili in onkan tlatsintlan;
y con sus santas manos las tomó y	au ka imatikatsinko konmokuili,
de nuevo en el hueco de mi ayate las vino a colocar,	okseppa nokuixanko okonualmotemili,
para que te las viniera a traer, para que a ti personalmente te las diera.	inik nimitsualnotkililis, in uel Teuatsin nimitsnomakilis.
Aunque bien sabía yo que no es lugar donde se den flores la cumbre del cerrito, porque sólo hay abundancia de riscos, abrojos, huizachez, nopales, mezquites, no por ello dudé, no por ello vacilé.	Masiui in ka uel nikmattia kamo imochiuyan xochitl in ikpak tepetsintli, ka san tetexkala, netsola, uitstla, tenopala, miskitla amo ik oninotsotson, amo ik nomeyoloak.
Cuando fuí a llegar a la cumbre del cerrito miré que ya era el paraíso.	In nasito in ikpak tepetsintli in nitlachix ka ye xochitlalpan.
Allí estaban ya perfectas todas las diversas flores preciosas, de lo más fino que hay, llenas de rocío, esplendorosas, de modo que luego las fuí a cortar;	Onkan senkistok in ixkich nepapan tlasoxochitl kaxtilankayotl auach, tonameyotok, inik niman oniktetekito.
y me dijo que de su parte te las diera, que ya así yo probaría; que vieras la señal que le pedías para realizar su amada voluntad,	Au onechmoluili inik ipampa nimitsnomakilis; au ka ye yu nik neltitlia inik onkan tikmottilis in itla neskayotl in tikmitlanilia inik tikmoneltililis in itlanekilistsin;
y para que aparezca que es verdad mi palabra, mi mensaje,	iuan inik nesi ka neltilistli in notlatol, in nonetitlanis:
aquí las tienes; hazme favor de recibirlas”.	Ka iska, ma xikmoselili.”
Y luego extendió su blanca tilma, en cuyo hueco había colocado las flores.	Au ka niman ik kiualsou in istak itilma in okikuixanotikaka xochitl.
Y así como cayeron al suelo todas las variadas flores preciosas,	Au in yu ualtepeu in ixkich nepapan kaxtilan xochitl,
luego allí se convirtió en señal, se apareció de repente la Amada Imagen de la Perfecta Virgen Santa María, Madre de Dios, en la forma y figura en que ahora está,	niman onkan momachioti, nestikis in itlasoixiptlatsin is senkiska Ichpochtli Santa Maria Teotl Dios Inantsin in yukatsintli axkan moyetstika,
en donde ahora es conservada en su amada casita, en su sagrada casita en el Tepeyac, que se llama Guadalupe.	in onkan axkan mopixtsinotika in itlasochantsinko in iteokaltsinko Tepeyakak, motokayotia Guadalupe.
Y en cuanto la vio el Obispo Gobernante y todos los que allí estaban, se arrodillaron, mucho la admiraron,	Au in oyukimottili in Tlatoani Obispo iuan in ixkichtin onkan katka motlankuaketske, senka kimauisoke,
se pusieron de pie para verla, se entristecieron, se afligieron, suspenso el corazón, el pensamiento…	kimotstimoketske, tlaokoxke, moyoltoneuke, yukin ajkoya in inyolo in intlalnamikilis…
Y el Obispo Gobernante con llanto, con tristeza, le rogó, le pidió perdón por no luego haber realizado su voluntad, su venerable aliento, su venerable palabra,	Au in Tlatoani Obispo chokistika, tlaokoyalistika kimotlatlautili, kimitlanilili in itlapopoluililoka inik amo niman okineltili, in itlanekilistsin, in iiyotsin in itlatoltsin.
y cuando se puso de pie, desató del cuello de donde estaba atada, la vestidura, la tilma de Juan Diego	Au in omokets kiualton in ikechtlan ik ilpitikatka in itlaken, in itilma Juan Diego.
en la que se apareció, en donde se convirtió en señal la Reina Celestial.	in itech omonexiti in onkan omomachiotitsino in Iluikak Siuapili.
Y luego la llevó; allá la fue a colocar a su oratorio.	Au niman ik kimouikili; ompa kimotlalilito in ineteochiuayan.
Y todavía allí pasó un día Juan Diego en la casa del Obispo, aún lo detuvo.	Au ok onka osemiluiti in Juan Diego in ichantsinko Obispo, ok kimotsikalui.
Y al día siguiente le dijo:—”Anda, vamos a que muestres dónde es la voluntad de la Reina del Cielo que le erijan su templo”.	Au in imostlayok kilui: “—Sake, inik tikteittitis in kanin itlanekilistsin Iluikak Siuapili kimokechililiske in iteokaltsin.”
De inmediato se convidó gente para hacerlo, levantarlo.	Niman ik tetlaluilok inik mochiuas moketsas.
Y Juan Diego, en cuanto mostró en dónde había mandado la Señora del Cielo que se erigiera su casita sagrada, luego pidió permiso:	Au in Juan Diego in oyukitteititi in kanin kimonauatili in Iluikak Siuapili moketsas iteokaltsin, niman ik tenauati:
quería ir a su casa para ir a ver a su tío Juan Bernardino, que estaba muy grave cuando lo dejó para ir a llamar a un Sacerdote a Tlatilolco para que lo confesara y lo dispudiera, de quien le había dicho la Reina del Cielo que ya había sanado.	in ok onasisneki in ichan inik konittatiu in itlatsin Juan Bernardino, in uelanautok, in ikuak kiualkauteuak seme kinotsaskia Teopixke in onkan Tlatilolko, inik kiyolkuitiskia, kisenkauaskia; in kimoluili Iluikak Siuapili in ye opatik.
Pero no lo dejaron ir solo, sino que lo acompañaron a su casa.	Au amo san isel kikauke yas, ka kiuikake in ompa in ichan;
Y al llegar vieron a su tío que ya estaba sano, absolutamente nada le dolía.	Au in oyu asito kittake in itlatsin ye uel paktika, niman atle kikokoa,
Y él, por su parte, mucho admiró la forma en que su sobrino era acompañado y muy honrado;	Au in yeuatl senka kimauiso in kenin imach ualuiko, iuan senka mauistililo;
le preguntó a su sobrino por qué así sucedía, el que mucho le honraran;	kitlatlani in imach tleika in yuki chiualo, in senka mauistililo:
Y él le dijo cómo cuando lo dejó para ir a llamarle un sacerdote para que lo confesara, lo dispusiera, allá en el Tepeyac se le apareció la Señora del Cielo;	Au in yeuatl kilui in kenin ikuak ompa ualeuak in kinochiliskia teopixki in kiyolkuitis, kisenkauas, in onkan Tepeyakak kimottilitsino in Iluikak Siuapili;
y lo mandó a México a ver al Gobernante Obispo, para que allí le hiciera una casa en el Tepeyac.	au kimotitlani in ompa Mexiko in kittatiu in Tlatoani Obispo inik onkan kimokaltilis in Tepeyakak.
Y le dijo que no se afligiera, que ya su tío estaba contento, y con ello mucho se consoló.	Au kimoluili in makamo motekipacho in ka ye paktika; in ik senka moyolali.
Le dijo su tío que era cierto, que en aquel preciso momento lo sanó,	Kilui in itlatsin ka ye neli ka niman ikuak in kimopatili,
y la vio exactamente en la misma forma en que se le había aparecido a su sobrino,	iuan uel kimottili is san no uel ye iukatsintli in yu kimottititsinoaya in imach,
y le dijo cómo a él también la había enviado a México a ver al Obispo;	iuan kimoluili in kenin yeuatl ok okimotitlanili Mexiko in kittas Obispo;
y que también, cuando fuera a verlo, que todo absolutamente le descubriera, le platicara lo que había visto	Au ma no in ikuak kittatiu, ma uel moch ik kixpantis kinonotsas in tlein okittak,
y la manera maravillosa en que lo había sanado,	iuan in kenin tlamauisoltika okimopatili;
y que bien así la llamaría, bien así se nombraría: La Perfecta Virgen Santa Maria de Guadalupe, Su Amada Imagen.	au ma uel yu kimotokayotilis, ma uel yumotokayotitsinos is senkiska Ichpochtsintli Santa Maria de Guadalupe in itlasoixiptlatsin.
Y luego trajeron a Juan Bernardino a la presencia del Gobernante Obispo, lo trajeron a hablar con él, a dar testimonio,	Au niman ik kiualuikake in Juan Bernardino in ixpan Tlatouani Obispo in kinonotsako, in ixpan tlaneltiliko.
y junto con su sobrino Juan Diego, los hospedó en su casa el Obispo unos cuantos días,	Au ineuan in imach Juan Diego kinkaloti in ichan Obispo achi keskiluitl,
en tanto que se levantó la casita sagrada de la Niña Reina allá en el Tepeyac, donde se hizo ver de Juan Diego.	inok ixkich ika moketsino iteokaltsin Tlatoka Siuapili in onkan Tepeyakak in kanin kimottitili in Juan Diego.
Y el Señor Obispo trasladó a la Iglesia Mayor la amada Imagen de la Amada Niña Celestial.	Au in Tlatouani Obispo kikuani ompa in Iglesia Mayor in itlasoixiptlatsin in Iluikaktlasosiuapili.
La vino a sacar de su palacio, de su oratorio en donde estaba, para que todos la vieran, la admiraran, su amada Imagen.	Kiualmokixtili in ompa itekpanchan in ineteochiuayan moyetstikatka: inik mochi tlakatl kittas kimauisos in Itlasoixiptlatsin.
Y absolutamente toda esta ciudad, sin faltar nadie, se estremeció cuando vino a ver, a admirar su preciosa Imagen.	Au uel senmochi is semaltepetl olin, in kiualmottiliaya, in kimauisoaya in Itlasoixiptlatsin.
Venían a reconocer su carácter divino.	Ualateomatia,
Venían a presentarle sus plegarias.	kimotlatlautiliaya.
Mucho admiraron en qué milagrosa manera se había aparecido,	Senka kimauisoaya in kenin teotlamauisoltika inik omonexiti,
puesto que absolutamente ningún hombre de la tierra pintó su amada Imagen.	inik niman ma aka tlaltikpak tlakatl okimikuilui in itlasoixiptlayotsin.
¿Qué cosa y cosa una jícara azul, sembrada de maíces tostados, que se llaman momochtli? Éste es el cielo, que está sembrado de estrellas.	Zazan tleino, xoxouhqui xicaltzintli, momochitl ontemi. Aca qittaz tozazaniltzin, tla ca nenca ilhuicatl.
¿Qué cosa y cosa que va por un valle, y lleva las tripas arrastrando? Ésta es el aguja cuando cosen con ella, que lleva el hilo arrastrando.	Zazan tleino, icuitlaxcol quihuilana, tepetozcatl quitoca. Aca quittaz tozazaniltzin, tla ca nenca huitzmalot.
¿Qué cosa y cosa un teponaztli de una piedra preciosa y ceñido con carne viva? Es la orejera hecha de piedra preciosa, que está metida en la oreja.	Zazan tleino, chalchiuhteponaztli, nacatica cuitlalpitoc. Aca quittaz tozazaniltzin, tla ca nenca nacochtli.
¿Qué es cantarillo de palo que conoce la región de los muertos? Es el cántaro para sacar el agua.	Zazan tleino, cuatzocoltzin mictlan ommati. Aca quittaz tozazaniltzin, tla ca nenca apilolli, ic atlacuihua.
¿Qué cosa y cosa diez piedras que las tiene alguno a cuestas? Éstas son las uñas, que están sobre los dedos.	Zazan tleino, matlactin tepatlactli quimamamatimani. Aca quittaz tozazaniltzin, tla ca nenca tozti.
¿Qué cosa y cosa que se toma en una montaña negra [bosque negro] y se mata en una estera blanca? Es el piojo, que se toma en la cabeza y se mata en la uña.	Zazan tleino, tlicuauhtla ommana, iztac tepatlacpan oalmiqui. Aca quittaz tozazaniltzin, tla ca nenca atemitl: tocpac toconana, toztipan tiqualteca: oncan toconmictia.
¿Qué cosa y cosa una caña hueca que está cantando? Es el sacabuche.	Zazan tleino, cocozacatzin mocuicuicatia. Tla ca nenca sacapuch.
¿Qué cosa y cosa un negrillo, que va escribiendo con vidriado? Son los caracolitos negros, que cuando van andando dejan el camino por donde van vidriado con unas babitas que dejan.	Zazan tleino, cacatzactli temetzica tlacuiloa. Teccizmamaque.
¿Qué es aquello que apunta al cielo con las manos? Es el maguey que alza sus espinas.	Zazan tleino, ilhuicac ommapilotoque. Huitztli.
¿Qué es lo que tiene naguas de sola pierna y busca piojos? Es el peine, que en medio tiene una pierna de manta angosta y de ambas partes las púas que sacan los piojos de la cabeza.	Zazan tleino, icezocuetzin (in centzoncuentzin), moteahatemilia. Tzicuahuaztli.
¿Qué cosa y cosa que en todo el mundo encima de nosotros se encorva? Son los penachos del maíz, cuando se van secando y encorvando.	Zazan tleino, cemanahuac topapancololtzitzin. Miyahuatl.
¿Qué cosa y cosa una vieja monstruosa, debajo de tierra, que anda comiendo y royendo? Es el topo.	Zazan tleino, tezahuilama tlallan tlacuacua. Tozan.
¿Qué cosa y cosa una cosita pequeñita, de plata, que está atada con una hebra de hilo de color castaño? Es la liendre, que está como atada al cabello.	Zazan tleino, teocuitlapolotziquitzin yapalichtica mecayotica. Ayelli.
¿Qué cosa y cosa (un) espejo que está en una casa hecha de ramos de pino? Es el ojo, que tiene las cejas como ramada de pino.	Zazan tleino, tezcatzintli acxoyacaletica. Tixtelolo.
¿Qué cosa y cosa un cerro como loma, y mana por dentro? Son las narices.	Zazan tleino, tepetlamimilolli itic ameya. Toyac.
¿Que cosa y cosa que muele con pedernales, y allí tiene un cuero blanco echado, y está cercado con carne? Es la boca que tiene los dientes con que masca, y la lengua tendida en medio; está cerrada con carne, son los labios.	Zazan tleino, tecpatica texoa, cuetlaxtli oncan onoc, nacatica tzacqui. Tocamac.
¿Qué es lo que tiene la cara blanda, el cogote duro encajado en la carne? Es el dedo de la mano que tiene de una parte la carne blanda y de la contraria, una uña encajada.	Zazan tleino, ixnacapapatz, cuexcochcacalach. Tomapil.
¿Qué es frente de carne metida está? También es el dedo.	Zazan tleino, ixnaca quechomiyo. Zan ye no yehoatl in tomapil.
¿Qué es corredores por delante, van empujando a ellos? Las rodillas.	Zazan tleino, ixtexolochtzitzin quintopeuhtiuh. Totlanqua.
¿Qué cosa y cosa una vieja que tiene los cabellos de heno, y está cerca de la puerta de la casa? Es la troje del maíz.	Zazan tleino, zaca tzonteilama tequiyaoac moquequetza. Cuezcomatl.
¿Qué es colorada y delgadilla y muerde apresuradamente? Es la hormiga.	Zazan tleino, tlapaltepitzactli ayoui tequa. Azcatl.
¿Qué cosa y cosa que dice: salta tú, que yo saltaré? Es la mano del teponaztli, con que lo tienen.	Zazan tleino, xoncholo, noncholoz: yehoatl in olmatil.
¿Qué es voy acullá, ve tú a la otra parte? Es el maxtle que él un cabo va a una parte y el otro a la contraria y tórnase a anudar.	Zazan tleino, nipa niyauh, nipa xiyauh, ompa toncanamiquizque. Maxtlatl.
¿Qué cosa y cosa piedra blanca, y de ella nacen plumas verdes? Es la cebolla.	Zazan tleino, iztac tetzintli, quetzalli conmantica. Xonacatl.
¿Qué cosa y cosa que tiene los cabellos canos hasta el cabo, y cría plumas verdes? La cebolla.	Zazan tleino, quiztalcomoctzin, quetzalli conmantica: zan ye no yehuatl in xonacatl.
¿Qué cosa y cosa que entramos por tres partes, y salimos por una? La camisa.	Zazan tleino, excanpa ticalaqui, zan cecni tiquiza. Ca tocamisa.
¿Qué cosa y cosa que le rascan las costillas y está dando gritos? Es el hueso que (se) usa en los areitos por sonajas.	Zazan tleino, comicicuiltataca chiquilichtzatzitoc. Omichicacaztli.
¿Qué cosa y cosa, que tiene las costillas de fuera y está levantado en el camino? Es el cacaxtli.	Zazan tleino, omicicuilpapanpul otlica moquetzitac. Cacaxtli.
¿Qué es lo que tomas presto de su agujero y arrójaslo en el suelo? Son los mocos, que se toman de las narices y se arrojan en el suelo.	Zazan tleino, itlacoyoc tenpan ticmacuitiuetzi, tlalli ic ticquappitzoa. Ca yehoatl in yacacuitlatl.
¿Qué cosa y cosa que entra en la montaña y lleva la lengua sacada? Es el hacha.	Zazan tleino, quauhtla calaqui nenepilotiuh. Tepoztli.
¿Qué cosa y cosa está arrimado a la azotea, el bellaco cabeza de olla? La escalera, que se arrima para subir a la azotea.	Zazan tleino, tetlapantenco moquequetza quateconpol. Ecacaztli.
¿Qué es camisa muy apretada? Es el tómatl, que tiene el cuero muy justo y pegado a sí.	Zazan tleino, huipiltitich. Tomatl.
¿Qué es: Ya sale, toma tu piedra? Es la cámara (diarrea).	Zazan tleino, ye oalquiza xiccui moteuh. Cuitlatl.
¿Qué cosa y cosa van guiando las plumas coloradas, y van tras ellas los cuervos? Es la chamusquina de las cabañas.	Zazan tleino, cuezali teyacana, cacali’n tetocatiuh. Tlachinolli.
¿Qué cosa y cosa que tiene cotaras de piedra, y está levantando a la puerta de la casa? Son los postes colaterales de la puerta.	Zazan tleino, itetecac, tecaltenpan moquequetza. Tlaquetzalli.
¿Qué es lo que en un día se empreña? Es huso con la mazorca. (Es decir, el huso que se llena de hilo en un momento.)	Zazan tleino, zan cemilhuitl otzti. Malacatl.
¿Qué es lo que está levantando la puerta y está encorvada la punta? Es la cola del perro.	Zazan tleino, texcaltenpa moquetzaticac pancololli. Chichicuitlapalli.
¿Qué es lo que está por dentro lleno de rodelas? Es el chile, que está por dentro lleno de semillas de hechura de rodelitas.	Zazan tleino, chimalli iitic tentica. Ca chilli: auh ye in iachyo chimalli.
¿Qué cosa y cosa que va por un valle, y va dando palmadas con las manos, como la mujer que hace pan? Es la mariposa, que va volando.	Zazan tleino, tepetozcatl quitoca momamatlaxcalotiuh. Papalotl.
¿Qué es piedra negra con boca abajo? Aquella sabandija que se llama pinácatl, que tiene el cuerpo negro y siempre está cabeza abajo, como quien está escuchando hacia el infierno.	Zazan tleino, tliltic tetl itzonic icac, ontlacactoc mictlan. Pinacatl.
¿Qué cosa y cosa una piedra almagrada, (que) va saltando? Es la pulga.	Zazan tleino, tlatlauhqui tetl colotiuh. Tecpi.
¿Qué sobre las piedras es redondo y está cantando? Es la olla donde se cuece el maíz.	Zazan tleino, teticpac totolon cuicaticac. Nexcomitl.
¿Qué está en el camino y está mordiendo? Es la piedra en que tropezamos en el camino.	Zazan tleino, otlica tequatica. Ca titotecuinia tetl.
¿Qué está en el camino asentada, de hechura de tintero? Es lo que el perro echa.	Zazan tleino, otlica eoatica paltetzocoton. Chichi icuitl.
¿Que en lo alto es redondo y barrigudo y está bulléndose y da voces? Es la sonaja que se llama ayacachtli.	Zazan tleino, aco cuitlayaoalli, mouiuixoa tzatzi. Ayacachtli.
¿Bailan los barrigudos y pantorrilludos? Es el huso.	Zazan tleino, i(n) ncitotiayan quititique, cotztique. Camalacatl.
 Y todo esto pasó con nosotros. Nosotros lo vimos, nosotros lo admiramos: con esta lamentosa y triste suerte nos vimos angustiados.	 Au in yeixkichi ipa mochiua in tikittake intikmauisoke in techokti tetlaokolti inik tlaijiyouike.
 En los caminos yacen dardos rotos, los cabellos están esparcidos. Destechadas están las casas, enrojecidos tienen sus muros. Gusanos pululan por calles y plazas, y en las paredes están los sesos. Rojas están las aguas, están como teñidas, y cuando las bebimos, es como si bebiéramos agua de salitre.	 Au in otlika omitl xaxamantok tsontli momoyautok. Kali tsontlapoutok kali chichiliutok. Okuilti moyakatlamina otlika. Au inkaltech, jajalakatok in kuatextli. Au yn atl sa yuki chichiltik sa yuki tlapatlatl ka yu tikike tikia tekixkiatl.
 Golpeábamos, en tanto, los muros de adobe, y era nuestra herencia una red de agujeros. Con los escudos fue su resguardo, pero ni con escudos puede ser sostenida su soledad. Hemos comido palos de colorín (eritrina), hemos masticado grama salitrosa, piedras de adobe, lagartijas, ratones, tierra en polvo, gusanos… Comimos la carne apenas sobre el fuego estaba puesta. Cuando estaba cocida la carne de allí la arrebataban, en el fuego mismo, la comían.	 Au ok ipa tiktetsotsonaya xamitl, au in atlakomoli ka toneixkauil chimaltitla in ipialoya in ok nen aka nik kisekilisneki [mote ysemilisneki] sa chimaltitlan tikkuake in tsonpa kuauitl in tekix­ki­sakatl xantetl in kuetspali kimichi teutlakili. Okuili titone techquake in akaselotl in ikuak tlepa kimontlaliaya y ye yusik inakayo onkan konouio… tleko kiquaya.
 Se nos puso precio. Precio del joven, del sacerdote, del niño y de la doncella. Basta: de un pobre era el precio sólo dos puñados de maíz, sólo diez tortas de mosco; sólo era nuestro precio veinte tortas de grama salitrosa.	 Au in topatiu mochiu in ipatiu mochiu, telpochtli itlakasitiu mochiu kano matechoktik axaxayaka, tlaxkali in tlamakaski, in ichpochtli, in piltsintli in ye ixkich maseuali in ipatiu mochiu sa omatekuchtli tlaoli sa matlaktli axaxayakatlaxkali tekixkisakatlaxkali sa sempouali tonatiu topatiu.
 Oro, jades, mantas ricas, plumajes de quetzal, todo eso que es precioso, en nada fue estimado. Solamente se echó fuera del mercado a la gente cuando allí se colocó la catapulta.	 Mochiu in teokuitlatl, in chalchiuitl in kuachtli in ketsali ye ixkich tlasotli atleypa mottak sa tetepeui in oyu konketske kuautematlatl in tiankisko.
 Ahora bien, a Cuauhtémoc le llevaban los cautivos. No quedan así. Los que llevan a los cautivos son los capitanes de Tlacatecco. De un lado y de otro les abren el vientre. Les abría el vientre Cuauhtemoctzin en persona y por sí mismo.	 Au yeuatsin Kuautemoktsin kimouikilia in malti amo yu kikaua in tekauato achkauti tlatlakateka nekok kitititsa kimititlapanaya yoma Kuautemoktsin.
Allí se dice cómo lloró Motecuhzomatzin y lloraron los mexicanos cuando supieron que los españoles eran muy fuertes	Oncan mitoa in quenin chocac Motecuhzomatzin, ihuan in chocaque mexica, in icuac oquimatque, ca cenca chicahuaque in Españoles.
Ahora bien, Motecuhzoma cavilaba en aquellas cosas, estaba preocupado; lleno de terror, de miedo: cavilaba qué iba a acontecer con la ciudad. Y todo el mundo estaba muy temeroso. Había gran espanto y había terror. Se discutían las cosas, se hablaba de lo sucedido.	Auh in Motecuzohma cenca tlatenma, motenma, momauhti, mizahui, quitlatenmachili in altepetl; ihuan in ye ixquich tlacatl, cenca momauhtique, nemauhtiloc, neizahuiloc, tlatenmachoc, netenmachoc,
Hay juntas, hay discusiones, se forman corrillos, hay llanto, se hace largo llanto, se llora por los otros. Van con la cabeza caída, andan cabizbajos. Entre llanto se saludan; se lloran unos a otros al saludarse. Hay intento de animar a la gente, se reaniman unos a otros. Hacen caricias a otros, los niños son acariciados.	nenonotlazlo, nececentlalilo, neohololo, nechoquililo, nechochoquililo, techoquililo, za tlaquechpilihui, za tlaquechhui, nechoquiztlapalolo, techoquiztlapalolo, teellacuahualo, neelacuahualo, tepetlalo, pepetlalo in pipiltzitzinti:
Los padres de familia dicen:	in tetahuan quitoa:
—¡Ay, hijitos míos!… ¿Qué pasará con vosotros? ¡Oh, en vosotros sucedió lo que va a suceder! …	–Hueh nopilhuantzitzine, quen huel amehuantin in huamopan mochiuh, in tlein ye mochihuaz,
Y las madres de familia dicen:	auh intenanhuan quitoa:
—¡Hijitos míos! ¿Cómo podréis vosotros ver con asombro lo que va a venir sobre vosotros?	–Nonopilhuantzitzin, que zo huel amehuanti in anquimahuizozque in tlein ye topan mochihuaz.
También se dijo, se puso ante los ojos, se le hizo saber a Motecuhzoma, se le comunicó y se le dio a oír, para que en su corazón quedara bien puesto:	Ihuan ilhuiloc, ixpantiloc, machtiloc, nonotzaloc, caquitiloc, iyollo itlan tlaliloc in Motecuzohma:
Una mujer, de nosotros los de aquí, los viene acompañando, viene hablando en lengua náhuatl. Su nombre, Malintzin; su casa, Teticpac. Allá en la costa primeramente la cogieron.	ce cihuatl nican titlaca in quinohualhuicac, in hualnahuatlatotia: itoca Malintzi teticpan ichan, in ompa atenco, achto canaco.
[Y luego que esto comenzó, ya no hubo quien estuviera puesto a su servicio, que los enviados, a quienes tocaba todo lo que necesitaban y en quienes estaba el cargo de ello, no hacían más que volverles las espaldas.]	Auh niman icuac peuh: in aocmo onnecxitlalilo, in za mocuitlacueptinemi in titlanti, in ipan ontlatoa in izquitlamantli, in izquican icac in intech monequiz.
Por este tiempo también fue cuando ellos (los españoles), hacían con instancia preguntas tocante a Motecuhzoma: cómo era, si acaso muchacho, si acaso hombre maduro, si acaso viejo. Si aún tenía vigor, o si ya tenía sentido de viejo, si acaso ya era un hombre anciano, si tenía cabeza blanca.	Auh zan niman no icuac in quitemotihuitze Motecuhzoma: ¿quenami cuix telpochtli, cuix iyoloco oquichtli, cuix ye huehue, cuix ye tlachicalhuia, cuix ye huehue tlamati, cuix ye huehue tlacatl, cuix ye cuaiztac?
Y les respondían a los “dioses”, a los españoles:	Auh quinnanquiliaya in teteo in Españoles:
—Es hombre maduro; no grueso, sino delgado, un poco enjuto; no más cenceño, de fino cuerpo.	–Ca iyoloco oquictli, amo tomahuac, zan pitzactontli, zan pipitzactontli, zan cuilotic, cuilotcatontli.
Pues cuando oía Motecuhzoma que mucho se indagaba sobre él, que se escudriñaba su persona, que los “dioses” mucho deseaban verle la cara, como que se le apretaba el corazón, se llenaba de grande angustia. Estaba para huir, tenía deseos de huir; anhelaba esconderse huyendo, estaba para huir. Intentaba esconderse, ansiaba esconderse. Se les quería esconder, se les quería escabullir a los “dioses”.	Auh in yuh quicaquia in , Motecuzohma, in cenca temolo, in cenca matataco cenca ixco tlachiaznequi in teteo yuhquin patzmiquia iyolo, yolpatzmiquia, cholozquia, choloznequia, mocholtiznequia, mocholtizquia, motlatizquia, motlatiznequia, quinnetlatiliznequia, quinneinaliznequia in teteo.
Y pensaba y tuvo el pensamiento; proyectaba y tuvo el proyecto; planeaba y tuvo el plan; meditaba y andaba meditando en irse a meter al interior de alguna cueva.	Auh in quimoyolotica, quimoyolotiaya, quimopictica, quimopictiaya, quiyocoxca, quiyocoaya; ic moyolnonotzca, ic poyolnonotzaya itic: quimolhuica, itic quimolhuayaya cana oztoc calaquiz,
Y a algunos de aquellos en quienes tenía puesto el corazón, en quienes el corazón estaba firme, en quienes tenía gran confianza, los hacía sabedores de ello. Ellos le decían:	auh cenca intech moyolaliaya intech huel catca iyollo, intech tlacuauhtlamatia: cequintin quimomachiztiaya, in quitoaya.
“Se sabe el lugar de los muertos, la Casa del Sol, y la Tierra de Tláloc, y la Casa de Cintli. Allá habrá que ir. En donde sea tu buena voluntad.”	Ca ommati in mictlan, ihuan tonatiuh ichan, ihuan tlalocan ihuan cincalco inic ompatiz in campa ye huel motlenequiliz.
Por su parte él tenía su deseo: deseaba ir a la Casa de Cintli (templo de la diosa del maíz).	Auh ye huel ompa motlanequiliaya, motlanequili in cincalco:
Así se pudo saber, así se divulgó entre la gente.	huel yuh machoc, huel yuh tepan motecac.
Pero esto no lo pudo. No pudo ocultarse, no pudo esconderse. Ya no estaba válido, ya no estaba ardoroso; ya nada se pudo hacer.	Auh inin amo huelit, amo huel motlati, amo huel minax, aoc yehuat, aoc tle tic, aoc yehuatix, aoc ye onneltic, aoc tle huel mochiuh
La palabra de los encantadores con que habían trastornado su corazón, con que se lo habían desgarrado, se lo habían hecho estar como girando, se lo habían dejado lacio y decaído, lo tenía totalmente incierto e inseguro por saber (si podría ocultarse) allá donde se ha mencionado.	in intlatol tlaciuhque, inic quiyolcuepca, inic quiyolapanca. Inic quiyolmalacachoca, inic cuitlacuepilica, in quimomachitocaca in ommati, in ompa omoteneuh;
No hizo más que esperarlos. No hizo más que resolverlo en su corazón, no hizo más que resignarse; dominó finalmente su corazón, se recomió en su interior, lo dejó en disposición de ver y de admirar lo que habría de suceder.	zanquinmochialti, zan moyolotechiuh, moyolochichili, quihualcentlami, quihualcentlancua in iyollo, quimocenmacac in zazo tlein quittaz, quimahuizoz.
Allí se dice el relato con que dieron en cuenta a Motecuhzoma los enviados que fueron a ver la barca	Oncan mitoa in tlatolli inic quinonotzato in Motecuhzoma, in titlani in quittato acalli
Hecho esto, luego dan cuenta a Motecuhzoma. Le dijeron en que forma se habían ido a admirar y lo que estuvieron viendo, y cómo es la comida de aquéllos.	Auh niman ye yuhqui, niman ye ic quinonotza in Motecuhzoma yuh quilhuique in yuhqui oquimahuizoto, ihuan quittitique in yuhqui intlacual.
Y cuando él hubo oído lo que le comunicaron los enviados, mucho se espantó, mucho se admiró. Y le llamó a su asombroso en gran manera su alimento.	Auh in oquicac in yuh tlanonotzque in titlani cenca momauhti, mizahui, ihuan cenca quimahuizo in intlacual:
También mucho espanto le causó el oír cómo [estalla el cañón, cómo retumba su estrépito, y cuando cae,] se desmaya uno; se le aturden a uno los oídos.	Oc cenca yehuatl in quiyolmicti in oquicac in quenin huetzi in innahuatil in tlequiquiztli, iuhquin tlatlatziniic caquizti in icuac huetzi, huel tezotlauh, motzatzacua in tonacaz.
Y cuando cae el tiro, una como bola de piedra sale de sus entrañas: va lloviendo fuego, va destilando chispas, y el humo que de él sale, es muy pestilente, huele a lodo podrido, penetra hasta el cerebro causando molestia.	Auh in icuac huetzi iuhquin telolotli hualquiza itic, tlepipixauhtiuh, chichitocatiuh: Auh in ipozio cenca iyac, zoquiyac, huel tetzonhuitec:
Pues si va a dar con un cerro, como que lo hiende, lo resquebraja, y si da contra un árbol, lo destroza hecho astillas, como si fuera algo admirable, cual si alguien le hubiera soplado desde el interior.	Auh in quimotla tepetl iuhquin xitini, xixitica: Auh in cuahuitl quimotlatetextia, iuhquin atetlachialti, iuhquin aca conilpitza.
Sus aderezos de guerra son todos de hierro: hierro se visten, hierro ponen como capacete a sus cabezas, hierro son sus espadas, hierro sus arcos, hierro sus escudos, hierro sus lanzas.	Zan mochi tepoztli in inyaotlatqui, tepoztli in conmaquia, tepoztli in conaquiz intzontecon, tepoztli in inmacuauh, tepoztli in intlahuitol, tepoztli in inchimal, tepoztli in intopil.
Los soportan en sus lomos sus “venados”. Tan altos están como los techos.	Auh in quinmama in inmazahua, iuhquin tlapantli ic cuacuauhtique.
Por todas partes vienen envueltos sus cuerpos, solamente aparecen sus caras. Son blancas, son como si fueran de cal. Tienen el cabello amarillo, aunque algunos lo tienen negro. Larga su barba es, también amarilla, el bigote también tienen amarillo. [Los negros que los acompañan] Son de pelo crespo y fino, un poco encarrujado.	Ihuan nohuian quimilihui in innacayo, zan ye neci in inxayac, cenca iztac, ixtetenextique, tzoncoztique, tel cequi tliltic in intzon, huiac in intentzon no coztic, tentzoncoztique, cocototztique ocolochtic:
En cuanto a sus alimentos, son como alimentos humanos: grandes, blancos, no pesados, cual si fueran paja. Cual madera de caña de maíz, y como de médula de caña de maíz es su sabor. Un poco dulces, un poco como enmielados: se comen como miel, son comida dulce.	Auh in intlacual yuhquin tlacatlacualli, hueitepul, iztac, amo etic yuhquin tlazolli, yuhquin ohuacuahuitl, yuhquin ohuacuauhtextli inic ahuiac, achi tzopelic, achi nenecutic monecticticacua, motzopelicacua:
Pues sus perros son enormes, de orejas ondulantes y aplastadas, de grandes lenguas colgantes; tienen ojos que derraman fuego, están echando chispas: sus ojos son amarillos, de color intensamente amarillo. Sus panzas, ahuecadas, alargadas como angarilla, acanaladas. Son muy fuertes y robustos, no están quietos, andan jadeando, andan con la lengua colgando. Manchados de color como tigres, con muchas manchas de colores.	Auh inimitzcuihuan huehueypopol, nacazcuecuelpachtique, tenhuihuilaxpopol, ixtletletique, ixtletlexochtique, ixcocoztique, ixtlecocoztique, xillanhuicoltique, xillanhuacaltique, xillancapitztique huel cuacuauhtique, amo tlaca mani neneciuhtinemi, nenenepilotinemi, ocelocuicuiltique, mocuicuiloque.
Cuando hubo oído todo esto Motecuhzoma se llenó de grande temor y como que se le amorteció el corazón, se le encogió el corazón, se le abatió con la angustia.	Auh in oyuh quicac in Motecuhzoma, cenca momauhti iuhquin yolmic, moyoltequipacho, moyolacoma.
De las señales y pronósticos que aparecieron antes que los españoles vinieran a esta tierra, ni hubiese noticias de ellos.	Inic ce capitulo oncan mihtoa in nez, in mottac in machiotl ihuan in tetzahuitl, in ayamo hualhui españoles, in nican tlalli ipan, in ayamo no iximachoa in nican chaneque.
Diez años antes que llegasen los españoles a esta tierra, y según otros once o doce años, apareció un gran cometa en el cielo, en la parte de oriente, que parecía como una gran llama de fuego muy resplandeciente y que echaba de sí centellas de fuego; este cometa era de forma piramidal, ancho de abajo e íbase aguzando hacia arriba hasta acabarse en una punta; aparecía en medio del oriente, comenzaba a aparecer un poco después de la media noche y llegaba hasta la mañana; la luz del sol lo encubría, de manera que saliendo el sol no parecía más.	In ayamo huallaci españoles, oc matlacxihuitl, centlamantli tetzahuitl achto nez, ilhuicatitech, iuhquin tlahuizcalli, pipixauhticaca inic necia, iuhquin ilhuicatl quizoticac: tzimpatlahuac, cuapitzaoac: huel inepantla in ilhuicatl; huel yollo in aciticac ilhuicatl, huel ilhuicayollotitech aciticac, in iuh ittoya ompa tlapcopa: in hualmoquetzaya, oyuh onquiz ihualnepantla in necia tlathuiliaya, ipan tlathuia, quin yehuatl quihualpoloaya in tonatiuh, in icuac hualquizaya:
Según algunos, viose un año entero, y según otros cuatro años arreo. Cuando aparecía de noche esta cometa todos los indios daban grandísimos alaridos y se espantaban, esperando que algún mal había de venir.	huel ce xihuitl in hualmoquetzaya (ipan matlactli omome calli in peuh). Auh in icuac necia tlacahuacaya, netenhuitecoya, neizahuiloya, tlatemmachoya.
Otro mal agüero aconteció aquí, en México, que el cu de Huitzilopochtli se encendió sin haber razón alguna humana para ello. Parece que milagrosamente se incendió y salían las llamas de dentro de los maderos hacia fuera, y de presto se quemó; dieron voces los sátrapas para que trajesen agua para matarlo, y cuanta más agua echaban tanto más ardía; del todo se quemó.	Inic ontetl tetzahuitl mochiuh, nican mexico: zan monomahui in tlatlac, cuetlan, ayac ma quitlecahui, zan monoma tlecahui in ical diablo Huitzilopochtli: mitoaya, iteioc itocayocan Tlacateccan: in nez ye tlatla in tlaquetzalli, in itec, hualquiza in tlemiyahuatl, in tlenenepilli, in tlecuezalotl, cenca zan iciuhca compalo in ixquich calcuahuitl: niman ye ic tlacahuaca, quitoa, Mexicae ma huallatotoca, tla cehuiloz, amaapilol: aun in icuac caatequiaya, in quicehuiznequia, zan ye ilhuice mopitza, aocmo huel ceuh, huel tlatlac.
El tercer mal agüero aconteció que cayó un rayo casi sin propósito y sin tronido, sobre el cu de dios llamado Xiuhtecutli; este cu tenía un chapitel de paja y sobre él cayó el rayo y le incendió y se quemó. Tuviéronlo por milagro, porque no hubo tronido, bien que llovía un poco menudo.	Inic etetl tetzahuitl: huitecoc ipan tlatlatzin teocalli, zan xacalli catca, itocayocan Tzommolco: iteopan in xiuhtecuhtli, amo tilahuaya , zan ahuachquiyahuiya in iuh tezammachoc: iuh mitoa in za zan tonalhuitecoc, amono caquiztic in tlatlatziniliztli.
El cuarto agüero fue que de día, estando el sol muy claro, vino de hacia el oxiden te de México un cometa que corrió hacia el oriente, e iba echando de sí como brasas o grandes centellas; llevaba una cola muy larga, y luego toda la gente comenzó a dar alaridos, juntamente, que parecía cosa de espanto, y por tal lo tuvieron.	Inic nauhtetl tetzahuitl: oc onca in tonatiuh in xihuitl huetz yeteyetia, ompa hualpeuh in tonatiuh icalaquiampa; aun ompa itztia in iquizayanpa, iuhqui in tlexoxhitl pipixauhtiuh, hueca acitiuh in icuitlapil: auh in oittoc cenca tlacahuacac, iuhquin oyohualli omoman.
El quinto fue que la laguna de México, sin hacer viento ninguno, se levantó, parecía que hervía y saltaba en alto el agua e hízose gran tempestad en la laguna, y las olas batieron en las casas que estaban cerca y derrocaron muchas de ellas; tuviéronlo por milagro porque ningún viento corría.	Inic macuiltetl tetzahuitl: pozon in atl, amo yehecatl quipozonalti, iuhquin momomoloca, iuhquin xixittemomoloca, cenca hueca in ya, inic macoquetz: auh in calli tzitzintla cacic, auh capapachiuh, xixitin in calli: yehuatl in huey atl totlan mani nican Mexico.
El sexto agüero fue que en aquellos días oyeron voces en el aire, como de una mujer que andaba llorando, y decía de esta manera: ¡Oh hijos míos! Ya estamos a punto de perdernos. Otras veces decía: ¡Oh hijos míos!, ¿a dónde os llevaré?.	Inic chicuacentlamantli tetzahuitl: miecpa cihuatl cacoya chocatiuh, tzatzitiuh, yohualtica cenca tzatzi; quitotinemi. Nonopilhuantzitzin, ye ic zan ye tonhui: in quenmanian quitoa. Nonopilhuantzitzin, campa namechnohuiquiliz.
El séptimo agüero fue que los pescadores o cazadores del agua tomaron en sus redes un ave del tamaño y color de un águila, la cual tenía en medio de la cabeza un espejo. Ésta fue cosa nunca hasta entonces vista, y así lo tuvieron por milagro, y luego la llevaron a Moteccuzoma, que estaba en el palacio en una sala que se llama tlillancalmécac; esto era después de medio día.	Inic chicontlamantli tetzahuitl: ceppa tlatlamaya, manozo tlamatlahuiaya in atlaca; centetl cacique tototl nextic, iuhquin tocuilcoyotl: niman quittitito in Motecuzoma, tlillan, calmecac; ommotzcalo in tonatiuh, oc tlaca,
Y Moteccuzoma miró al ave, y miró al espejo que tenía en la cabeza, el cual era redondo y muy pulido, y mirando en él vio las estrellas del cielo, los mastelejos que ellos llaman mamalhuaztli;	iuhquin tezcatl icpac mani, malacachtic, tehuilacachtic, iuhquin xapotticac: ompa onnecia in ilhuicatl, in cicitlatlin, in mamalhuaztli.
y Moteccuzoma espantóse de esto y apartó la vista, haciendo semblante de espantado, y tornando a mirar el espejo que estaba en la cabeza del ave, vio en él a gente de a caballo, que venían todos juntos, en gran tropel y todos armados; y viendo esto se espantó más, y luego envió a llamar a los adivinos y astrólogos y al los sabios en cosas de agüeros, y preguntólos: ¿qué es esto que aquí me ha aparecido? ¿Qué quiere decir? Y estando así todos espantados desapareció el ave, y todos quedaron espantados, y no supieron decir nada.	Auh in Motecuzoma, cenca quimotetzahui in icuac quimittac cicitlatlin, ihuan mamalhuaztli. Auh inic oppa ontlachix in icpac tototl, ene quittac, iuhqui on in ma acame, moquequetztihuitze, tepeuhtihuitze, moyahuachichiuhtihutze, quinmama mamaza. Auh niman quinnotz in tlaciuhque, in tlamatinime: quimilhui: Amo anquimati in tlein onoconittac, iuhquin acame moquequetztihuitze: auh ye quinanquilizquia, in conittaque, opoliuh, aoc tle quitoque.
El octavo agüero fue que aparecieron en muchos lugares hombres con dos cabezas; tenían no más de un cuerpo, y dos cabezas: llevábanlos a que los viese Moteccuzoma en su palacio, y en viéndolos luego desaparecían sin decir nada.	Inic chicuetetl tetzahuitl: miecpa motenextiliaya, tlaca, tlacanetzolti, ontetzontecomque, zan ze intlac, ompa quimonhuicaya in tlillan calmecac, ompa quimittaya in Motecuzoma, in oquimittac niman polihuia.
Cuauhcoatl y Axolohua fueron pasando y miraron mil maravillas allí entre las cañas y las juncias. Ese había sido el mandato que les dio Huitzilopochtli a ellos que eran sus guardianes, eran sus padres los dichos. Lo que les dijo fue así: «En donde se tienda la tierra entre cañas y entre juncias, allí se pondrá en pie, y reinará Huitzilopochtli». Así por su propia boca les habló y esta orden les dio. Y ellos al momento vieron: sauces blancos, allí enhiestos; cañas blancas, juncias blancas, y aun las ramas blancas, peces blancos, culebras blancas; es lo que anda por las aguas. Y vieron después donde se parten las rocas sobre puestas, una cueva cuatro rocas la cerraban. Una al oriente se ve, nada de agua tiene, es sin agua que se agita. La segunda roca de la cueva ve al norte: se ve que está sobrepuesta, y de ella sale el agua que se llama agua azul, agua verdosa.	Auh ino ipan quizato inoquittaque cenca miectlamantli in tlanahuizolli in oncanca in acaihtic caye ihca ipampa in nahuatil yuhquimilhui in Huitzillopochtli in teomamaque in itahuan in Quauhtlequetzqui anozo in Quauhcohuatl in Axollohua tlamacazqui ca quin nahuati ca yuhquimilhui in ixquich in oncan inonoc in tollihtic in acaihtic in oncan ihcaz, in oncan tlapiez in yehuatl in Huitzilopochtli ca itencopa quimilhui ca yuhquin nahuati in Mexica, auh niman oquittaque iztac in ahuehuetl, iztac in huexotl, in oncan ihcac, ihuan iztac in acatl, iztac in tolli, ihuan iztac in cueyatl iztac in michin, iztac in cohuatl, in oncan nemi atlan, auh niman oquittaque nepaniuhticac intexcalli in oztotl, inic ce in texcalli in ozotl tonatiuh iquizayan itztoc itoca tleatl, Atlatlayan. Auh inic ome in texcalli in oztotl mictlampa Ytztoc, inic nepaniuhtoc, itoca Matlallatl, ihuan itoca Toxpallatl.
Cuando esto vieron los vieron los viejos, se pusieron a llorar. Y decían «¿Conque aquí ha de ser?». Es que estaban viendo lo que les había dicho, lo que les había ordenado Huitzilopochtli. Es que él les había dicho: «Habéis de ver maravillas muchas entre cañas y entre juncias». «Ahora las estamos mirando» decían ellos, «¡y quedamos admirados! ¡Cuan verdadero fue lo dicho, bien se realizó su orden!». Van a buscar a los mexicanos y les dicen: «Mexicanos, vamos, vamos a admirar lo que hemos contemplado. Digamos al sacerdote; él dirá qué debemos hacer». Fueron a Temazcatitlan y allí se detuvieron.	Auh inoquittaque niman yechoca in huehuetque quitohua anca yenican yez, caotiquittaque intechilhui inic technahuati in tlamacazqui in Huitzlipochtli inquihto inyuhqui anquittazque in Tollihtic in acaihtic miectlamantli in oncan ca auh in axcan coatiquittaque, otic mahuizoque, caye nelli caomochiuh caoneltic in tlatol inic technahuati, niman oquihtoque Mexicaye maoctihuian caotitlamahuizoque maoctic tlatolchiyecan in tlamacazqui yehuatl quimati quenin mochihuaz, niman ohuallaque motlallico in oncan Temazcaltitlan,
Por la noche vinieron a ver, vinieron a mostrarse unos a otros y era el sacerdote Cuauhtlaquezqui, que es el mismo Huitzilopochtli. Dijo él: —Cuauhcóhuatl, ¿habéis visto allí todo, lo que hay entre cañas y juncias? ¡Aún resta ver otra cosa! No la habéis visto todavía. Id y ved un nopal salvaje: y allí tranquila veréis un Águila que está enhiesta. Allí come, allí se peina las plumas, y con eso quedará contento vuestro corazón. ¡Allí está el corazón de Cópil que tu fuiste a arrojar allá donde el agua hace giros y más giros! Pero allí donde vino a caer, y habéis visto entre los peñascos, en aquella cueva entre cañas y juncias. ¡Del corazón de Cópil ha brotado ese nopal salvaje! ¡Y allí esperaremos y allí reinaremos! ¡Allí esperaremos y daremos el encuentro a toda clase de gentes! Nuestros pechos, nuestra cabeza, nuestras flechas, nuestros escudos. ¡Allí les haremos ver! ¡A todos los que nos rodean allí los conquistaremos! ¡Aquí estará perdurable nuestra ciudad de Tenochtitlan! ¡El sitio donde el Águila grazna, en donde abre las alas; el sitio donde ella come y en donde vuelan los peces, donde las serpientes van haciendo ruedos y silban! ¡Ese será México Tenochtitlan y muchas cosas han de suceder! Dijo entonces Cuauhcóhuatl: —¡Muy bien está, mi señor sacerdote! ¡Lo concedió tu corazón: vamos a hacer que lo oigan mis padres los ancianos todos juntos! Y luego hizo reunir a los ancianos todos Cuauhcóhuatl y les dio a conocer las palabras de Huitzilopochtli. Las oyeron los mexicanos.	auh niman yohualtica in oquittac inoquimottiti in teomama initoca Quauhtlequetzqui anozo Quauhcohuatl in yehuatl in Huitzilopochtli, oquilhui Quauhcohuatle caohuanquittaque in ixquich in oncan onoc in acaihtic ohuan tlamahuizoque. Auh tlaxiccaquica occentlamantli in ayemo anquitta. Auh inin xihuian, xiquittati in Tenochtli in oncan anquittazque ic pacca icpac, ihcac in yehuatl in quauhtli oncan tlaqua, oncan mototonia, auh ca ic pachihui in amoyollo, ca yehuatl iniyollo in Copil intiqualmayauh in oncan timoquetz tlalcocomocco. Auh niman oncan huetzico ino anquittaque texcaltempa, Oztotempa in Acatzallan in toltzallan, auh ca oncan ixhuac iniyollo in Copil, in axcan motocayotia Tenochtli, auh ca oncan intiezque in titlapiezque, in titechiezque intitenamiquizque in nepapantlaca telchiquiuh totzonteco tomiuh tochimal, inic tiquimittazque in ixquich intechyahuallotoc ixquich tiquinpehuazque tiquimacizque ic maniz in taltepeuh Mexico Tenochtitlan quauhtli ipipitzcayan inetomayan quauhtli itlacuayan, ihuan michin ipatlanian, ihuan cohuatl izomocayan in Mexico in Tenochtitlan, auh ca miectlamantli in mochihuaz, niman oquilhui in Quauhcohuatl, cayequalli tlamacazque otlacauhqui imoyollotzin maquicaquican imottahuan in huehuetque in ixquichtin, ic niman oquincentalli in Mexica in Quauhcohuatl oquincaquilti initlatol in Huitzilopochtli inoquicacque Mexica.
Y de nuevo van allá entre cañas y entre juncias, a la orilla de la cueva. Llegaron al sitio donde se levanta el nopal salvaje, allí al borde de la cueva y vieron tranquila, parada, al Águila en el nopal salvaje. Allí come, allí devora y echa a la cueva los restos de lo que come. Y cuando el Águila vio a los mexicanos, se inclinó profundamente. Y el Águila veía desde lejos. Su nido y su asiento era todo él de cuantas finas plumas hay: plumas de azulejos, plumas de aves rojas y plumas de quetzal. Y vieron también allí cabezas de aves preciosas y patas de aves y huesos de aves finas tendidos por tierra.	Auh niman onoceppa yahque in Toltzallan in Acatzallan, in Oztotempa, auh ino ipan quizato Acatitlan ihcac in Tenochtli, in oncan (Oztotempa inoquittaque icpacca icpac ihcac moquetzticae in Quauhtli in yehuatl in Tenochtli oncan tlaqua, oncan quiqua quitzotzopitzticac in quiqua, auh in yehuatl in quauhtli inoquimittac in Mexica cenca omopechtecac in quauhtli, zan huecapa in conittaque) Auh initapazol inipepech, zan moch yehuatl in ixquich inepapan tlazo ihuitl in ixquich in xiuhtotoihuitl, in tlauhquecholihuitl, in ixquich quetzalli, auh zan no oncan quittaque in oncan tetepeuhtoc inin tzonteco inepapan totome in tlazototome in tzonteco oncan zozoticate, ihuan cequitoto icxitl, cequi omitl,
Le habló el dios y así les dijo: —¡Ah, mexicanos: aquí sí será! ¡México es aquí! Y aunque no veían quién les hablaba, se pusieron a llorar y decían: —¡Felices nosotros, dichosos al fin! ¡Hemos visto ya dónde ha de ser nuestra ciudad! ¡Vamos y vengamos a reposar aquí!	auh oncan quinnotz in Diablo quimilhui Mexicaye ye onca yecin, auh yece amo quitta in Mexica in aquinquinotza ic oncan tlatocayotique Tenochtitlan auh niman ye ic choca in Mexica quitohua otocnopiltic, otomacehualtic caotic mahuizoque in taltepeuh yez, maoctihuian, maoctitocehuiti.
Cuarto capítulo, donde se dice el agüero, de lo que se tenía por augurio cuando el tecolote lloraba.	Ik naui kapitulo , onkan mitoa in tetsauitl inik motetsauiaya, in ikuak tekolotl chokaya.
También era tenido por augurio, se tenía por augurio, era conocido el agüero cuando el tecolote cantaba.	No iuan netetsauioya, tlatetanuiaya, tetammachoya in tekolotl choka.
Cuando en el borde de la azotea de alguno, o sobre su jacal[np], sobre sus árboles está cantando, lo oye que está diciendo: ” Tecolo , o , o , tecolo , o , o .” De esta manera era oído, así llora.	In ikuak tla aka itlapantenko, anoso ixakaltikpak, ikuautikpak chokatika, in kikaki kitotika: “tekolo, o, o, tekolo, o, o.” Iuin in kakisti, inik choka.
Decían que cuando era oído, descubría la muerte, la enfermedad; era augurio de muerte. El que lo oyó quizá muera; quizá termine; quizá se canse. Morirá en su tierra, o quizá morirá en la guerra; o quizá morirá uno de sus hijos; o quizá un esclavo huirá; o quizá se destruirá su hogar; será sacada la tierra; el agua brotará; persistirá el yerbazal en la puerta, en el patio; las paredes serán derribadas, serán arrancadas, demolidas; ahí defecará la gente, se orinará, excrementará; será arrojada basura; se secará el salitre, la tierra echará vaho.	Kitoa in ikuak in kakoya, kinextia mikistli, kokolistli; mikistetsauitl. In akin okikak aso ye mikis; aso tlasiuiti; aso tlatlatsiuiti. Tlamikis, anoso yaomikis; anose aka se ipiltsin ye mikis; anoso itlakau ye cholos; aso ye tlalpoliuis in ichan; tlali kanauas; atl nenesis; akauatimanis in kiyauatl, in ituali; tepantli xixitintos, tlauiuitontos, tlaueuelontos; onkan nexixalos neaxixalos; nemanauilos; tlasolaxos; tekixkitl koxontos; tlali ipotokatos.
Entonces será objeto de habladurías, será objeto de escándalo. Así, aquí estaba ésta, la casa donde era honrado, donde se venía a afamar el dueño. siempre se mantuvo honrada; estaba toda barrida. Pero ahora aquí es echada la basura: Junto a su casa ninguno podía orinarse ni reñir: Y ahora ya solo así quedó; sólo permanecen las paredes.	Ikuak itolos, inik tlamauisolos; y eyukan okatka in, ichan in onkan ontlamamautiko, in onkan onmoteyotiko chane. Mochipa otlamauismamanka, otlatetskaliutimanka. Ma sel kana se tlasoli ouetstoka. Au in ikaltech ayak uel omaxixaya, teauaya. Yu in axkan ye sa yukan; sa tepantli yeuatok.
Capítulo quinto. Habla acerca de la acción de pasar sobre alguien.	Inic macuilli capítulo . Itechpa tlatoa in tecuencholhuiliztli.
Otro desatino de la gente de aquí, acerca de la acción de pasar sobre alguien: Cuando algún niño está echado por donde se pasa, si alguien lo salta, entonces riñen al que lo saltó, le dicen: “¿Por qué lo saltas?”	In itechpa tecuencholhuiliztli no centlamantli innetlapololtiliz in nican tlaca; in icuac tla aca melahuatoc piltontli, necuiliuhtoc, intla aca oconcuencholhui, niman cahua in aquin otecuencholhui, quilhuia: “¿Tle ipampa in ticcuencholhuia?”
Dizque por esto el niño ya no crecerá; sólo será tamañito. Y para curarlo, para evitar que le suceda [el mal], otra vez lo saltan en sentido contrario. Así lo curan.	Quilmach in ayocmo manaz in piltontli; ca ixquichton yez. Auh inic compatiaya, inic amo ipan mochihuaz piltontli, oc ceppa quihualpancholhuia. Ic ompatia.
Décimo cuarto capítulo. Habla acerca de la tortilla que se dobla en el comal.	Inic matlactli onnahui capítulo . Itechpa tlatoa in comalco mocuelpachoa tlaxcalli.
Cuando las mujeres hacen tortillas, si su tortilla se dobla, también hay un desatino. Dicen: “Alguien viene ya golpea con el pie”.	In icuac tlaxcaloa in cihua, intla ocuelpachiuh itlaxcal, no oncatca innetlapololtiliz. Quitoa: “Aquin ye huitz; oquihualtiliczac.”
Y si quizá su marido [de la que hace tortillas] fue a algún lugar lejano, dice: “Ya viene, ya golpea con el pie mi tortilla.”	Auh in anoce ioquichhui in canapa hueca oya, quitoaya: “Ca ye huitz, ca quihualtiliczac in notlaxcal.”
Trigésimo capítulo. Habla acerca del estornudo.	Inic cempoalli ommatlactli capítulo . Itechpa tlatoa in acucholiztli.
"Antiguamente se decía cuando alguno estornudaba: “Alguien habla de mí, alguien me mienta.” O quizá decía: “Alguien habla de mí.” O quizá decía:
“Algunos discuten acerca de mí.” Dizque cuando estornudaban esto les demostraba, esto les daba a conocer que alguno, en lugar lejano, los mentaba."	In icuac aca acuchoa quitoaya in ye huecauh: “Aquin nechitoa, aquin nechtenehua.”. Anoce quitoaya: “Aquin nechicoitoa.” Anoce quitoa: “Aquique in noca mononotza.” Quil yehuatl quinezcayotiaya, yehuatlic quimatia, in icuac acuchoa in aca, canapa, hueca quintenehua.
Trigésimo séptimo capítulo. Habla acerca de los niños que mudan los dientes.	Inic cempoalli on caxtolli omome capítulo . Itechpa tlatoa in icuac huetzi intlan pipiltonti.
Cuando caen los dientes de los niños, sus madres los echan en el agujero del ratón, o quizá les dicen a sus hijos: “Ponlo en el agujero del ratón.” Porque dizque si así no lo hicieran, no podrían nacer los dientes de los niños, sólo serían desdentados.	In icuac huetzi intlan pipiltotonti, in tenanhuan itlacoyocco contlaza in quimichin, anoce inpilhuan quimilhuia: “Itlacoyocco xictlali in quimichin.” Yehica quil intlacamo yuh quichihuazque, amo huel ixhuaz in itlan piltontli, zan tlancotoctic yez.
Mucho honraban los mexicas a Huitzilopochtli, sabían ellos que su origen, su principio fue de esta manera: En Coatepec, por el rumbo de Tula, había estado viviendo, allí habitaba una mujer de nombre Coatlicue. Era madre de los cuatrocientos Surianos y de una hermana de éstos de nombre Coyolxauhqui.	In Uitsilopochtli, in senka kimauistiliaya in Mexika. Iuin in kimatia, in itsinyilis, in ipeualis, ka in Koatepek, iuikpa in Tulan, semiluitl kitstika, ompa nenka siuatl, itoka Koatlikue: innan sentsonuitsnaua. Au inueltiu, itoka Koyolxau.
Y esta Coatlicue allí hacía penitencia, barría, tenía a su cargo barrer, así hacía penitencia, en Coatepec, la Montaña de la Serpiente. Y una vez, cuando barría Coatlicue, sobre ella bajó un plumaje, como una bola de plumas finas. En seguida lo recogió Coatlicue, lo colocó en su seno. Cuando terminó de barrer, buscó la pluma, que había colocado en su seno, pero nada vio allí. En ese momento Coatlicue quedó encinta. Al ver los cuatrocientos Surianos que su madre estaba encinta, mucho se enojaron, dijeron: «Quién le ha hecho esto?, ¿quién la dejó encinta? Nos afrenta, nos deshonra».	Au in yeuatl Koatlikue, onkan tlamaseuaya, tlachpanaya, kimokuitlauiaya, in tlachpanali. Inik tlamaseuaya, in Koatepek. Au seppa in ikuak tlachpanaya, in Koatlikue ipan ualtemok iuitl, yukin iuitelolotli, niman konkuitiuets in Koatlikue: ixilan kontlali, au in ontlachpan niman konkuiskia in iuitl, in ixilan okitlalika aok tle kittak, niman ik otstik in Koatlikue. Au in okittake in sentsonuitnaua in innan ye otstli, senka kualanke kitoke ¿ak okichiuili i? ¿akin okotsi? techauilkixtia, techpinautia.
Y su hermana Coyolxauhqui les dijo: «Hermanos, ella nos ha deshonrado, hemos de matar a nuestra madre, la perversa que se encuentra ya encinta. ¿Quién le hizo lo que lleva en el seno?»	Au in inueltiu in Koyolxau: kimilui nokichtiuan techauilkixtia san tikmiktia in tonan, in tlauelilok in ye otstli: ak okichiuili in itik ka.
Cuando supo esto Coatlicue, mucho se espantó, mucho se entristeció. Pero su hijo Huitzilopochtli, que estaba en su seno, la confortaba, le decía: «No temas, y osé lo que tengo que hacer». Habiendo oído Coatlicue las palabras de su hijo, mucho se consoló, se calmó su corazón, se sintió tranquila.	Au in okima Koatlikue: senka momauti, senka motekipacho. Au in ikoneu in itik katka kiyolaliaya, kiualnotsaya kiluaya, maka ximomauti ye ne nikmati, in okikak in Koatlikua, in itlatol in ikoneu, senka in moyolali, motlali in iyolo, yukin yukantlama.
Y entretanto, los cuatrocientos Surianos se juntaron para tomar acuerdo, y determinaron a una dar muerte a su madre, porque ella los había infamado. Estaban muy enojados, estaban muy irritados, como si su corazón se les fuera a salir, Coyolxauhqui mucho los incitaba, avivaba la ira de sus hermanos, para que mataran a su madre. Y los cuatrocientos Surianos se aprestaron, se ataviaron para la guerra.	Au in ye yiuki, in sentsonuitsnaua in okisentlalike in intlatol, in okisemitokin, isa kimiktiske in innan, yeijka ka otlapinauti, sa senka mochikauaya, senka kualania, yuki in kisaya in iyolo, in Koyolxauki, senka kineleuaya, kiniolokokoltiaya in yokichtiua, in makuele miki in innan. Au in Sentsonuitsnaua, niman ye in mosenkaua, moyauchichiua.
Y estos cuatrocientos Surianos eran como capitanes, torcían y enredaban sus cabellos, como guerreros arreglaban su cabellera. Pero uno llamado Cuahuitlicac era falso en sus palabras. Lo que decían los cuatrocientos Surianos, en seguida iba a decírselo, iba a comunicárselo a Huitzilopochtli. Y Huitzilopochtli le respondía: «Ten cuidado, está vigilante, tío mío, bien sé lo que tengo que hacer».	Au in yeuantin sentsonuitsnaua, iukin tekiuake katka tlakuiaya, tlakuauikuiaya, kikuauikuiaya in intson, in inkuatson, in inkuatson. Au se itoka Kuauitlikak, nekok kitlalitinenka in itlatol, in tlein kitouaya sentosnuitsnaua, niman koiluiaya, konnonotsaya in Uitsilopochtli. Au in Uitsilopochtli: kiualiuiaya in Kuauitlikak: senka tla tikmomachtia notlatsine, uel xonmotlakakilti ye ne nikmati.
Y cuando finalmente estuvieron de acuerdo, estuvieron resueltos los cuatrocientos Surianos a matar, a acabar con su madre, luego se pusieron en movimiento, los guiaba Coyolxauhqui. Iban bien robustecidos, ataviados, guarnecidos para la guerra, se distribuyeron entre sí sus vestidos de papel, su anecúyotl, sus ortigas, sus colgajos de papel pintado, se ataron campanillas en sus pantorrillas, las campanillas llamadas ayohualli. Sus flechas tenían puntas barbadas.	Au in ye yuki in yekene okisemitoke, in konetetix in intlatol, inik kimiktiske, inik kitlatlatiske in innan, niman ye ik ui teyakana in Koyolxauki, uel mochichikaua, mosesenketsa, moyauchichiuke, motlamamakake, intech kitlalike in imamatlatki, in aneukyotl, intsitsikas, amatitech pipilkak, tlakuiloli, iuan in koyoli inkotstitech kiyilpike, inin koyoli mitoaya ayouali, iuan inmiu tlatsontektli,
Luego se pusieron en movimiento, iban en orden, en fila, en ordenado escuadrón, los guiaba Coyolxauhqui. Pero Cuahuitlicac subió en seguida a la montaña, para hablar desde allí a Huitzilopochtli, le dijo: «Ya vienen». Huitzilopochtli le respondió: «Mira bien por dónde vienen». Dijo entonces Cuahuitlicac: «Vienen ya por Tzompantitlan». Y una vez más le dijo Huitzilopochtli: «Por dónde vienen ya?». Cuahuitlicac le respondió: «Vienen ya por Coaxalpan». Y de nuevo Huitzilopochtli preguntó a Cuahuitlicac: «Mira bien por dónde vienen». En seguida le contestó Cuahuitlicac: «Vienen por la cuesta de la montaña». Y todavía una vez más le dijo Huitzilopochtli: «Mira bien por dónde vienen». Entonces le dijo Cuahuitlicac: «Ya están en la cumbre, ya llegan los viene guiando Coyolxauhqui».	niman ye ik ui, tetekpantiui, tlatlamantitiui, tlayeyekotiui, momamantiui, teyakana in Koyolxauki. Au in Kuauitlikak, niman ye in motlalotitleko, in kinonotsas in Uitsilopochtli kilui ka ye uitse, niman kito in Uitsilopochtli uel xontlachie kan ye uitse, niman ye ik koniluia in Kuauitlikak: ka ye tsonpantitlan, ye no seppa kiualiuia in Uitsolopochtli kan ye uitsa niman konilui ka ye koaxalpan uitse, ye no seppa kiualilui, kan ye uitse niman konilui in Kuauitlikak: ka ye tlatlakapan yatiuitse. Au in Uitsilopochtli: ye no seppa kiualilui, in Kuauitlikak. Kilui tla xontlachia kan ye uitse. niman ik konilui in Kuauitlikak, ka yekene ualpanuetsi, yekene ualasi teyakantiuits in Koyolxauki.
En ese momento nació Huitzilopochtli, se vistió sus atavíos, su escudo de plumas de águila, sus dardos, su lanza-dardos azul, el llamado lanza-dardos de turquesa. Se pintó su rostro con franjas diagonales, con el color llamado «pintura de niño». Sobre su cabeza colocó plumas finas, se puso sus orejeras. Y uno de sus pies, el izquierdo era enjuto, llevaba una sandalia cubierta de plumas, y sus dos piernas y sus dos brazos les llevaba pintados de azul.	Au in Uitsilopochtli: niman ik ualakat, niman itlatki ualietia in ichimal, teueueli, iuan in imiu, iuan iyatlau xoxoktik, mitoa xiuatlatl, iuan ikxitlan tlatlan, ik ommichiu in ikonekuitl, mitoaya ipilnechiual, mokuapotoni, ixkuak, iuan inanakastlan, au se pitsauak in ikxi iyopochkopa, kipotoni in ixokpal, iuan kitexouauan in imets omexti. iuan omexti in iakol.
Y el llamado Tochancalqui puso fuego a la serpiente hecha de teas llamada Xiuhcoatl, que obedecía a Huitzilopochtli. Luego con ella hirió a Coyolxauhqui, le cortó la cabeza, la cual vino a quedar abandonada en la ladera de Coatepetl. el cuerpo de Coyolxauhqui fue rodando hacia abajo, cayó hecho pedazos, por diversas partes cayeron sus manos, sus piernas, sus cuerpo.	Au se itoka Tochankalki kontlati in xiukoatl, kiualnauati in Uitsilopochtli: niman ik kisil in Koyolxauki: au niman kechkotontiuets, in itsontekon ompa ommokau in itenpa Koatepetl. Au in itlak tlatsintlan uetsiko tetextitiuets, sesekkan ueuets in ima, in ikxi, iuan itlak.
Entonces Huitzilopochtli se irguió, persiguió a los cuatrocientos Surianos, los fue acosando, los hizo dispersarse, desde la cumbre de Coatepetl, la montaña de la culebra. Y cuando los había seguido hasta el pie de la montaña, los persiguió, los acosó cual conejos, en torno de la montaña. Cuatro veces los hizo dar vueltas. En vano trataban de hacer algo en contra de él, en vano se revolvían contra él, al son de los cascabeles y hacían golpear sus escudos. Nada pudieron hacer, nada pudieron lograr, con nada pudieron defenderse.	Au in Uitsilopochtli: niman ye ualeua, kinoualtoka intlan aki, kinoualtemouia, kinoualtepeua in Sentsonuitsnaua, in Koatepetl ikpak. Au in okimaxitiko in tlalchi, in tlatsintlan, niman ye ik kintoka, kiniayaualochti in Koatepetl, nappa in kintlatlayaualochti, in kiniayaualochti, ok nen kiualoyutiuia ok nen kiualoyouiaya, ualmochimaluitektiuia, aok tle uel kichiuke, aok tle ual axke aokmo uel kitsauilike,
Huitzilopochtli los acosó, los ahuyentó, los destruyó, los aniquiló, los anonadó. Y ni entonces los dejó, continuaba persiguiéndolos. Pero ellos mucho le rogaban, le decían: «¿Basta ya?»	san kinsemeuiti in Uitsilopochtli: kinsentepotstli, uel kinpopolo, uel kimistlati, uel kinpoktlantili. Au in sa aokmo uel kinkauaya, in ouel in sentech mopilo, senka kitlatlautiaya, kiluiaya ma ixkich.
Pero Huitzilopochtli no se contentó con esto, con fuerza se ensañaba contra ellos, los perseguía. Sólo unos cuantos pudieron escapar de su presencia, pudieron librarse de sus manos. Se dirigieron hacia el sur, porque se dirigieron hacia el sur, se llaman Surianos, los pocos que escaparon de las manos de Huitzilopochtli. Y cuando Hiutzilopochtli les hubo dado muerte, cuando hubo dado salida a su ira, les quitó sus atavíos, sus adornos, su anecúyotl, se los puso, se los apropió, los incorporó a su destino, hizo de ellos sus propias insignias.	Au in Uitsilopochtli: amoik moyolseui, ka senka intech motlapalo in kintokak, Au sa keskitoton in ixpanpa euake, in imakpa kiske ompa itstiake, inin Sentsonuitsnaua, in okiskintin in imatitlanpa kiske in Uitsilopochtli: Au in ye yuki in okinmikti, in oyielelkis kinkuili in intlatki, in innechichiual in anekuiyotl, kimotlatkiti, kimaxkati, kimotonalti, yukin kimotlauisti.
Y este Huitzilopochtli, según se decía, era un portento, porque sólo una pluma fina, que cayó en el vientre de su madre, Coatlicue, fue concebido. Nadie apareció jamás como su padre. A él lo veneraban los mexicas, le hacían sacrificios, lo honraban y servían. Y Huitzilopochtli recompensaba a quien así obraba.	Au in Uitsilopochtli: no mitoa tetsauitl, yejika ka san iuitl, in temok inik otstik in inan in Koakue: kayak nes in ita. Yeuatl in okipiaya in mexika inik otamanitiaya, inik kimauistiliaya, okitlaekoltiaya, iuan in itech mochiuaya in Uitsilopochtli.
Y su culto fue tomado de allí, se Coatepec, la montaña de la serpiente, como se practicaba desde los tiempos antiguos.	Au in yeuatl in tlamauistililistli okatka, ka ompa tlamatli in Koatepek, in yu mochiui ka ye uekau.
Y en seguida se convocaron los dioses. Dijeron:	Au niman ye mononotsa in teteo. Kitoke:
—¿Quién vivirá en la tierra? porque ha sido ya cimentado el cielo, y ha sido cimentada la tierra. ¿Quién habitará en la tierra, oh dioses?	—¿Aki in onos kaomoman in iluikatl kaomoman in tlalteuktli aki onos Teteoye?
Estaban afligidos Citlalinicue, Citlaltonac, Apantecuchtli, Tepanquizqui, Quetzalcóatl y Tezcatlipoca.	Ye nentlamati in Sitlaliikue in Sitlalatonak in Apanteuktli, Tepankiski, tlalamanke, uiktlolinki Ketsalkouatl, Titlakauan.
Y luego fue Quetzalcóatl al Mictlan, se acercó a Mictlantecuhtli y a Mictlancíhuatl y en seguida les dijo:	Au niman ye yau in Ketsalkoatl in Miktlan: itech asito in Miktlantekutli in Miktlansiuatl, niman kilui:
—Vengo en busca de los huesos preciosos que tú guardas, vengo a tomarlos.	—Ka yeuatl ik niuala in chalchiuomitl in tikmopielia ka nikkuiko.
Y le dijo Mictlantecuhtli:	Au niman kilui:
—¿Qué harás con ellos, Quetzalcóatl?	—¿Tle tikchiuas, Ketsalkouatlé?
Y una vez más dijo (Quetzalcóatl):	Au yenoseppa kilui:
—Los dioses se preocupan porque alguien viva en la tierra.	—Ka yeuatl ik nentlamati in teteo: akin onok in tlatikpak.
Y respondió Mictlantecuhtli:	Au yenoseppa kito in Miktlantekutli:
—Está bien, haz sonar mi caracol y da vueltas cuatro veces alrededor de mi círculo precioso.	—Ka ye kuali, tla xokon pitsa in noteksis, au naupa xik tlayaualochti in nochalchiuteyaualko.
Pero su caracol no tiene agujeros; llama entonces (Quetzalcóatl) a los gusanos; éstos le hicieron los agujeros y luego entran allí los abejones y las abejas y lo hacen sonar. Al oírlo Mictlantecuhtli, dice de nuevo:	Au amo makoyonki in iteksis; niman ye kinnotsa in okuilme, kikokoyonike; niman ye ik ompa kalaki in xikoti in pipiolme; niman ye kipitsa, kiualkak in Miktlantekutli. Au yenoseppa kilui in Miktlantekutli:
—Está bien, toma los huesos.	—Ka moka ye iksen nikitki.
Pero dice Mictlantecuhtli a su servidores:	Au niman ye kiluia in ititlauan in Miktlantekutli:
—¡Gente del Mictlan! Dioses, decid a Quetzalcóatl que los tiene que dejar.	—In mikteka, xokon iluitin: ¿Teteué, san kikkauakiu?
Quetzalcóatl repuso:	Au in Ketsakouatl niman kiualito:
—Pues no, de una vez me apodero de ellos.	—Ka moka ye iksen nikitki.
Y dijo a su nahual:	Au niman kiluia in inaual:
—Ve a decirles que vendré a dejarlos.	—Ka xikimon ilui san nikauakiu.
Y éste dijo a voces:	Niman kiualiui in kitsatsilitiu:
—Vendré a dejarlos.	—San nikkauakiu.
Pero, luego subió, cogió los huesos preciosos. Estaban juntos de un lado los huesos de hombre y juntos de otro lado los de mujer y los tomó e hizo con ellos un ato Quetzalcóatl.	Au ik uel on tlekok, niman ye ik ye konkui in chalchiuomitl, sekni temi in okichtli in iyomio, no sekni temi in siuatl iyomio, niman ye ik kitkits.
Y una vez más Mictlantecuhtli dijo a sus servidores:	Au yenoseppa kimilui in Miktlantekutli in ititlauan:
—Dioses, ¿de veras se lleva Quetzalcóatl los huesos preciosos? Dioses, id a hacer un hoyo.	—Teteoyé, ye Nely kitki in Ketsalkouatl in chalchiuomitl. Teteoyé, xik ualalili in tlaxapochtli.
Luego fueron a hacerlo y Quetzalcóatl se cayó en el hoyo, se tropezó y lo espantaron las codornices. Cayó muerto y se esparcieron allí los huesos preciosos, que mordieron y royeron las codornices. Resucita después Quetzalcóatl, se aflige y dice a su nahual:	Niman kontlalilito inik onkan motlaxapochui, motlauitek, iuan kimautike sosoltin: miktiuets au in chalchiuomitl niman ik kisenmantiues, niman kikankuake in sosoltin, kiteteiske; au niman ik ualmoskali in Ketsalkouatl, niman ye ik choka, niman ye kiluia in inaual:
—¿Qué haré, nahual mío?	—¿Nonaualé, ke yes i?
Y este le respondió:	Au niman ye kiluia:
—Puesto que la cosa salió mal, que resulte como sea.	—Kenin yes, kanel otlatlakau masonel yuki yau.
Los recoge, los junta, hace un lío con ellos, que luego llevó a Tamoanchan. Y tan pronto llegó, la que se llama Quilaztli, que es Cihuacóatl, los molió y los puso después sobre un barreño precioso. Quetzalcóatl sobre él se sangró su miembro. Y en seguida hicieron penitencia los dioses que se han nombrado: Apantecuhtli, Huictolinqui, Tepanquizqui Tlallamánac, Tzontémoc y el sexto de ellos Quetzalcóatl. Y dijeron:	Au niman ye konnechikoa, kon pepen, konkimilo; niman ik kitkik in Tamoanchan, au in okonaxiti niman ye kitesi itoka Kilaxtli, yeuatl is Sippakouatl; niman ye ik kitema in chalchiuapasko, au niman ye ipan motepoliso in Ketsalkouatl; niman mochintin tlamaseua in teteoin nipa omoteneuke; niman Apantekutli, in Uiktlolinki, Tepankiski, Tlalamanak, Tesontemok, techikuaseka in Keskouatl: au niman kitoke:
—Han nacido, oh dioses, los macehuales (los merecidos por la penitencia).	—Otlakatke in teteo in maseualtin.
Porque, por nosotros hicieron penitencia (los dioses).	Ye ika in otopantlamaseuke.
"Así pues de nuevo dijeron (los dioses):
—¿Qué comerán (los hombres), oh dioses? ¡Que descienda el maíz, nuestro sustento!"	"Yenoseppa kitoke:
—¿Tlein kikuaske, teteoyé?"
"Pero entonces la hormiga va a coger el maíz desgranado, dentro del Monte de nuestro sustento Quetzalcóatl se encuentra a la hormiga, le dice:
—¿Dónde fuiste a tomar el maíz? dímelo."	"Au niman kikuito in askatl in tlaoli in itik Tonakatepetl, au niman ye kinamiqi in askatl in Ketsalkouatl kilui:
—¿Kan otikkuito? Xi nechilui."
Mas la hormiga no quiere decírselo. Quetzalcóatl con insistencia le hace preguntas. A cabo dice la hormiga: —En verdad allí. Entonces guía a Quetzalcóatl, éste se transforma en hormiga negra. La hormiga roja lo guía, lo introduce luego al Monte de nuestro sustento. Entonces ambos sacan y sacan maíz. Dizque la hormiga roja guió a Quetzalcóatl hasta la orilla del monte, donde estuvieron colocando el maíz desgranado. Luego Quetzalcóatl lo llevó a cuestas a Tamoanchan. Allí abundantemente comieron los dioses, después en nuestros labios puso maíz Quetzalcóatl, Y luego dijeron los dioses:	Au amo kiluisneki, senka kitekitlatlania, niman kiluia ka nechka niman ye kiuika, au niman ik tlilaskatl mokuep in Ketsalkoatl, niman ye kiuika; niman ye ik kalaki, niman ye ik kisasaka neuan in tlatlaukiaskatl in mache kiuikak in Ketsalkouatl tlatempan kiualalia in tlaoli, niman ye kitki in Tamoanchan, au niman ye ik totenko kitlalia “inik tiuapauke”, au niman ya kitoua:
—¿Qué haremos con el Monte de nuestro sustento?	—¿Ken tikkchiuaske in Tonakatepetl?
Mas el monte allí quiere quedarse, Quetzalcóatl lo ata, pero no puede jalarlo. Entre tanto echaba suertes Oxomoco, y también echaba suertes Cipactónal, la mujer de Oxomoco, porque era mujer Cipactónal.	Au niman san ya kimamasneki in Ketsalkouatl, kimekayoti, au amo keu; au niman ye kitlapouia in Oxomoko, au niman ye kitlapouia in Sipaktonal in isiuau…
"Luego dijeron Oxomoco y Cipactónal:
—Tan sólo si lanza un rayo Nanáhuatl, quedará abierto el Monte de nuestro sustento."	Aun niman kitike in Oxomoko in Sipaktonal ka san kiuiteki in Nanauatl in Tonakatepetl. Ka okitlapouike.
Entonces bajaron los tlaloques (dioses de la lluvia), los tlaloques azules, los tlaloques blancos, los tlaloques amarillos, los tlaloques rojos. Nanáhuatl lanzó enseguida un rayo, entonces tuvo lugar el robo del maíz, nuestro sustento, por parte de los tlaloques. El maíz blanco, el obscuro, el amarillo, el maíz rojo, los frijoles, la chía, los bledos, los bledos de pez, nuestro sustento, fueron robados para nosotros.	Au niman ye netlaluilo in Tlaloke: in xoxouki Tlaloke, istak Tlaloke, tlatlauki Tlaloke, kosauki Tlaloke; niman ye kiuiteki in Nanauatl au niman ye namoyelo in Tlaloke in tonakayotl: in istak, in yauitl, in kostik, in xiutoktli, in etl, in uautli, in chian, in michiuautli: ixkich namoyolok in tonakayotl.
Dicen que cuando aún es de noche, cuando aún no sale el Sol, cuando no amanece, dizque se juntaron en uno, se convocaron los dioses allá en Teotihuacan, dijeron, se dijeron unos a otros:	Mitoa in ok youayan, in ayamo tona, in ayamo tlatui, kilmach, mosentlalike, mononotske in teteo in umpa Teotiuakan, kitoke, kimoluike:
—Venid acá, dioses, ¿quién tomará el trabajo, quién se echará a cuestas el hacer salir el sol, el hacer amanecer?	—Tla xi ualuian, teteoé, ¿akin tlatkis, akin tlamamas in tonas, in tlatuis?
Y luego por cierto por allá habla aquel, se presenta delante Tecuciztecatl, dijo:	Au niman ye ik yeuatl unkan ontlatoa, onmixketsa in Tekusistekatl, kito:
—¡Dioses, yo tengo que ser!	—Tetetoé, ka neuatl niyes.
Una vez más dijeron los dioses:	Okseppa kitoke in teteu:
—¿Quién otro más?	—¿Akin okse?
Luego por esto juntos, se ponen a ver, se miran unos a otros, se dicen:	Niman ye ik nepanotl mota, kimottitia, kimoluia:
—¿Cómo ha de ser esto? ¿Cómo seremos nosotros?	—¿Ken onyes ji, ken tonyeske?
Nadie se atrevía para presentarse como otro más: sólo todas las personas tenían miedo, retrocedían. Y no se estaba presentando delante de otra persona.	Ayac motlapaloya, in occe onmixquetzaz; zan muchi tlacatl momauhtiaya, tzinquetzaya. Auh amo onnezticatca in ce tlacatl.
Nanahuatzin allí junto a ellos estaba oyendo lo que se determinaba: luego pues a este llamaron los dioses, le dijeron:	Nanahuatzin uncan tehuan tlacacticatca in nenonotzalo: niman ic yehuatl connotzque in teteo, quilhuique:
—Tú tienes que ser, Nanahuatzin.	—Tehuatl tiyez, Nanahuatzé.
Luego él vino en tomar la orden, la recibió de buena gana, dijo:	Niman quicuitihuetz in tlatolli, quipaccaceli, quito:
—Está bien, dioses, vosotros me habéis hecho una gracia.	—Ca ye cualli, teteoé, oannechmocnelilique.
Al punto, pues, comenzaron a hacer penitencia, ayunaron cuatro días ambos, él y Tecuciztecatl.	Niman ic compehualtique in ye tlamacehua, mozauhque nahuiilhuitl omextin in Tecuciztecatl.
En seguida por consiguiente se encendió fuego, ya arde allá en el fogón, y el fogón tenía el nombre de “roca divina”.	Auh niman no icuac motlali in tletl, ye tlatla in uncan tlecuilco, quitocayotia in tlecuilli teutexcalli.
Ahora bien, aquello con que Tecuciztecatl hacía penitencia, todo precioso: sus ramas de abeto, plumas de quetzal; sus bolas de grama, oro; sus espinas, jades; sus cosas ensangrentadas, sus sangramientos, coral, y su incienso un muy buen incienso.	Auh in yehuatl Tecuciztecatl in ipan tlamacehuaya muchi tlazotli: in iacxoyauh, quetzalli; in izacatapayol, teocuitlatl; in ihuitz, chalchihuitl; in ictlaezhuilli tlaezzotilli, tapachtli, auh in icopal, huel yeh in copalli.
Pero por lo que toca a Nanahuatzin, sus ramas de abeto se redujeron a cañas verdes, cañas tiernas, en manojos, gavillas, diversas atadas, todas ellas nueve, y sus bolas de grama, solo (eran) hoja seca de pino, y sus espinas no (eran) sino verdaderas espinas de agave y lo que se sangraba bien (era) en verdad su sangre, y su incienso, no más que la raedura de sus llagas de que estaba doliente.	Auh in Nanahuatzin in iacxoyauh mochiuh zan zacatl xoxouhqui, acaxoxouhqui, eein tlalpilli, tlacuitlalpilli, nepan chicunahui ye muchi; auh in izacatapayotl, zan yeh in ocozacatl; auh in ihuitz, zan ye no yeh imehuitztli auh in ic quezhuiaya huel yeh in iezzo, auh in icopal, zan yeh in inanahuauh concocolehuya.
A cada uno de estos se le hizo su monte, en donde estuvieron haciendo penitencia cuatro noches (dicen, por cierto, ahora a estos montes, “pirámides”: la pirámide del sol y la pirámide de la luna). Y cuando acabó el (término) de cuatro noches, de hacer penitencia, luego echaron por el suelo, arrojaron sus ramas de abeto y todo aquello con que habían hecho penitencia. Esto se hizo en el término de levantar la penitencia, cuando ya anochece para ponerse a su oficio, para hacerse dioses.	In omextin hin cecentetl intepeuh mochiuh, in umpa ontlamaceuhtinenca nauhyohual (mitoa yin axcan tetepe tzacualli: itzacual tonatiuh, ihuan itzacual metztli), auh in ontzonquiz nauhyohual in tlamacehualiz, niman quitlatlazato, quimamayahuito in imacxoyauh ihuan ye muchi ipan otlamaceuhque. In hin mochiuh ye in neehualco, icuac in yehualyohua tlacotizque, teotizque.
Y cuando llega la media noche luego pues les reparten, les atavían, les engalanan: a Tecuciztecatl le dieron su morrión de plumas de garza, cónico, y su chaleco; pero a Nanahuatl sólo papel: aquello con que liaron su cabeza se llama su cabellera de papel, y su tiara de papel y su braguero de papel.	Auh in icuac ye on aci yohualnepantla, niman ye ic quintlamamaca, quinchichihua, quincencahua: in Tecuciztecatl quimacaque iaztacon mimiltic ihuan ixicol; auh in Nanahuatzin, zan amatl, inic contzonilpique concuailpique, itoca iamatzon, ihuan iamaneapanal, ihuan iamamaxtli.
Y así pues, cuando hubo llegado la media noche, todos los dioses se pusieron a rodear el fogón, el llamado “roca divina”, en el cual por cuatro días había ardido el fuego, de uno y otro lado se pusieron en fila, y en medio colocaron, hicieron poner de pie a los dos llamados Tecuciztecatl y Nanahuatzin; los pusieron vuelta la cara, parados con la cara hacia el fogón.	Auh in ye yuhquin in ohuelacic yohualnepantla, in muchintin teteu quiyahualotimomanque in tlecuilli, in motenehua teutexcalli, in uncan nahui—ilhuitl otlatlac tletl, nenecoc motecpanque; auh nepantla quimonmanque quimonquetzque in omextin hi motenehua in Tecuciztecatl ihuan Nanahuatzin, quixnamictimoquetzque in tlecuilli.
Al punto pues mandan los dioses, dijeron a Tecuciztecatl:	Auh niman ye ic tlatoa in teteu, quilhuique in Tecuciztecatl:
—Ea pues, Tecuciztecatl, échate, arrójate al fuego.	—¡O tlacuele, Tecuciztecatlé, xon huetzi, xon momayahui in tleco!
Al punto va a arrojarse al fuego. Pero, cuando a él llegó el ardor, que (era) insoportable, insufrible, intolerable, como que mucho había estado ardiendo el fogón, se había hecho un fuego abrasador, se había hecho un gran montón de brasas, no hizo más que sentir miedo a su vista, pararse a medio camino, retroceder y volver atrás. Una vez más fue a intentar arrojarse, poniendo todas sus fuerzas, para lanzarse con ímpetu, para dar consigo en el fuego.	Niman ye ic yauh momayahuiz in tleco. Auh in itech acito totonillotl, in amo ixnamiquiztli, in amo yecoliztli, amo ihiyohuiliztli, inic cenca huel oxoxotlac tlecuilli, ohuelhualantimotlali, ohuelmotlatlali in tletl. Ic zan ommixmauhtito, onmotilquetzato, hualtzinquiz, hualtzinilot. Ye noceppa yauh tlayehecoz ixquich caana ic momotla, quimomaca in tletl.
Sin embargo, no pudo atreverse: no bien alcanzó a llegar a él el ardor, no pudo más que retroceder, echarse a huir: no era para sufrirlo. Hasta cuatro veces hizo otro tanto y no sufrió, sino que no pudo echarse al fuego. Sólo que allí era el mandato de cuatro veces. Y por tanto, había intentado cuatro veces: luego por esto gritan a Nanahuatzin y le dijeron los dioses:	Auh zan ahuel motlapalo, in ye no itech onaci totonqui, zan ahual tzinquiza, hualtzincholoa, amo ontlayecoa: ulnappa, tlaelnappa in yuh quichiuh in moyeheco, zan niman ahuel onmomayauh in tleco: ca zan ye uncan tlatenehualli in napan. Auh in ontlaquixti nappa; niman ye ic yeh contzatzilia in Nanahuatzin, quilhuique in teteu:
—Aun tú, aún para bien tú, Nanahuatzin, ¡ea pues!	—Oc tehuatl, occuel tehuatl. ¡Nanahuatzé, mayecuel!
Ahora bien, Nanahuatzin de una vez fue a atreverse, se hizo violencia, esforzó su corazón, cerró los ojos por no tener miedo; por nada se amedrentó, no se paró en la carrera, no retrocedió, sino que al punto se dejó caer, se fue a arrojar al fuego de una vez: al punto, pues, ya arde, chisporrotea y chilla (en el fuego) su carne.	Auh in Nanahuatzin zan cen in hualmotlapalo, quihualcentlami, quihuallancua in iyollo, hualixtetenmotzolo; amo tle ic mixmauhti, amo mo quequetz, amo motilquetz, amo tzinquiz; zan niman onmotlaztihuetz, onmomayauhtihuetz in tleco, zan ic cenya; niman ye ic tlatla, cuecuepoca, tzotzoyoca in inacayo.
Pues así que vio Tecuciztecatl que ya ardía, al momento también él se arrojó en él, con lo cual al punto ardía.	Auh in icuac oquittac Tecuciztecatl in ye tlatla quinicuac zan tepan ipan onmomayauh, niman ye no ic tlatla.
Y según dicen, dizque también entró el Águila, los siguió ella, por cuya causa su plumaje es oscuro y requemado.	Auh in yuh conitoa, quilmach, niman no ic onehuac in cuauhtli, quimontoquili, onmotlaztihuetz in tleco, onmotlecomayauh, oc yehuatl nohuellalac ipampan ihuiyo cuichehuac, cuichectic.
Igualmente se metió el Tigre, aun no mucho se quemó cuando cayó en el fuego, con él sólo se chamuscó, se pintó con el fuego, se medio quemó, del todo bien no se quemó, por lo cual sólo manchado, manchado de tinta, manchado o salpicado.	Auh zan ontlatzacui in océlotl, aocmo cenca huellala in tletl huetzito, ic za motlecuicuilo, motletlecuicuilo, motlechichino, aocmo cenca huellalac, ipampan zan cuicuiltic, motlilchachapani, motlilchachapatz.
Ahora bien, así que ambos se hubieron echado al fuego, inmediatamente se quemaron del todo. Luego se pusieron a esperar los dioses por dónde había de salir Nanahuatzin, el que primeramente se echó al fuego, para ser sol y para amanecer.	Auh in ye yuhqui in omextin onmomamayauhque tleco, inicuac ye otlatlaque. Niman ic quichixtimotecaque in teteu in campa yeh quizaquiuh in Nanahuatzin in achto onhuetz tleco inic tonaz, inic tlathui.
Cuando ya hubo pasado largo tiempo, cuando los dioses hubieron estado esperando, luego comienza a ponerse rojo, por todas partes rodea la aurora, la claridad de la luz. Según dicen, luego se arrodillan los dioses para esperar por dónde ha de salir el que se había hecho sol; hacia todas partes fijaron los ojos, hacia (ellas) fijaban los ojos dando vuelta alrededor. En parte alguna se puso de acuerdo su palabra, su pensamiento, nada bien fijo lo que dijeron.	Inicuac ye huecauhtica onoque mochixca onoque teteu, niman ye ic pehua in tlachichilihui nohuiyanpa tlayahuallo in tlahuizcalli in tlatlahuilotl. In yuh conitoa nimanye ic motlancuaquetza in teteu inic quichiezque in campa yeh quizaquiuh Tonatiuh omochiuh, nohuiyanpa tlachizque, ahuicpa tlachie—momalacachotinemi. Ahcan huel centetix in intlatol in innemachiliz, atle ihuelyaca in quitoque.
Algunos opinaron que del norte había de salir, por lo cual hacia allá estuvieron mirando; algunos que del poniente, algunos que del sur; hacia allá estuvieron mirando; por todas partes opinaron (que saldría) por razón de que la claridad rodeada estaba. Pero algunos bien estuvieron viendo hacia el oriente, dijeron:	Cequintin momatque ca Mictlampa in quizaquiuh, ic umpan itztimomanque; cequintin Cihuatlampa, cequintin Huitztlampa itztimomanque, nohuiyanpa motemachique ipampa in zan tlayahualo tlatlahuillotl. Auh in cequitin huel umpa itztimomanque in tlauhcopa, quitoque:
—Por cierto que por aquí, por allí ha de salir el sol.	—Ca yeh umpa hin, yeh uncan hin in quizaquiuh Tonatiuh.
Muy verdadera (fue) la palabra de los que allá estuvieron viendo, de los que allá señalaron con el dedo. Así se llaman aquellos que hacia allá estuvieron mirando: Quetzalcoatl, que por otro nombre, es Ehécatl, y Totec, o sea Anahuatlitecu (“el señor del anillo”), y Tezcatlipoca el rojo, como también los llamados “Serpientes de Nube, “que no tienen número, y cuatro mujeres: Tiacapan (“Nuestra hermana mayor”), Teicu, Tlacoyehua y Xocoyotl (“la que sigue; la de en medio, la menor”).	—Yehuantin huel neltic in itlatol in umpa tlachixque in umpa mapiloque. Yuh quitoa yehuantin in umpa tlachixque Quetzalcoatl, ic ontetl itoca Ehécatl, ihuan Totec, anozo Anahuatl itecu, ihuan Tlatlahuic—Tezcatlipoca, no yehuantin in motenehua Mimixcoa, in amo zan tlapoaltin, ihuan cihua nahuin: Tiacapan, Teicu, Tlacoyehua, Xocoyotl.
Y cuando vino a salir el sol, cuando se presentó delante, como pintado de rojo, se estuvo contoneando de un lado a otro, no era posible verle cara a cara, le mortificaba a uno los ojos, mucho brillaba, lanzaba rayos de luz (y) su irradiación fue a llegar a todas partes, su calor entró a todas partes.	Auh inicuac oquizaco in omomanaco Tonatiuh, yuhquin tlapalli monenecuilotimani, amo huel ixnamico, teixmimicti, cenca tlanextia, motonameyotia, in itonameyo nohuiyampa aacitimoquetz, auh in itonalmiyo nohuiyampa cacalac.
En seguida vino a salir Tecuciztecatl (que) lo iba siguiendo en el mismo punto del oriente junto a aquel se presentó que era el sol: tal como cayó en el fuego, de igual manera salieron, se fueron siguiendo.	Auh zatepan quizaco in Tecuciztecatl quihualtocatia zan ye no umpa in tlauhcopa itloc onmomanaco in Tonatiuh; auh in yuh onhuetz que tleco, zan no yuh hualquizque, hualmotocatiaque.
Ahora bien, según cuentan los que refieren y narran hablillas a la gente, se hizo igual su luz con que resplandecían; cuando los vieron los dioses que era igual su luz luego al punto de nuevo se hizo reunión (y) dijeron:	Auh in yuh conitoa tlatlanonotza tezazazanilhuia, zan neneuhqui in itlachieliz mochiuh, inic tlanextiaya; inicuac oquimittaque teteu in zan neneuhqui in itlachieliz, niman ye noceppa ic nennotzalo, quitoque:
—¿Cómo será?, ¿Cómo esto? Dioses, ¿Acaso ambos han de ir uno en pos de otro? ¿Ambos han de lucir y brillar igualmente?	—¿Quen yez que hin, teteuhé? ¿Cuix onteixtin ontlatocazque, onteixti yuh tlanextizque?
Y todos los dioses dieron su fallo, dijeron:	Auh in tetu muchintin huallatzontecque quitoque:
—Así será esto, así se hará esto.	—Yuh yez hin, yuh muchihuaz hin.
Luego una persona de los dioses salió corriendo, hirió la cara con un conejo a aquel Tecuciztecatl, con lo cual le estragó la cara, le hirió en la cara, tal como hasta ahora se ve.	Niman ic ce tlacatl omotlalotiquiz in teteu, ic conixhuihuihuitequito in tochin in yehuatl Tecuciztecatl, ic conixpopoloque ic conixcomictique in yuhqui axcan ic tlachie.
Ahora bien, así que ambos se presentaron, tampoco podían moverse, no podían seguir su marcha, sino que sólo estuvieron en pie, se mantuvieron en firme.	Auh in ye yuhqui inicuac ye omomanaco onteixtin, ye no cueleh ahuel olini, ahuel otlatoca, zan momanque, motetenmanque.
Por tanto, de nuevo dijeron los dioses:	Ic ye noceppa quitoque in teteu:
—¿Cómo hemos de vivir, no se mueve el sol? ¿Hemos de vivir acaso mezclados con los plebeyos (hombres)? Antes bien, por nuestra obra resuciten y medren, aun cuando todos nosotros muramos.	—¿Quen tinemizque? Amo olini in Tonatiuh. ¿Cuix tiquinnelotinemizque in macehualti: auh in hin ma toca mozcalti, ma timuchintin timiquican?
Al punto hizo su oficio Ehécatl (el viento) y da muerte a los dioses. Pero, según dicen, Xólotl no quería morir.	Niman ic yeh itequiuh in Ehécatl, ye quimiquita in teteu. Auh in yuh conitoa, Xólotl amo miquitlania.
Dijo a los dioses:	Quimilhui in teteu:
—¡No muera yo, oh dioses!	—Macamo nimiqui, teteuhé.
Por esto mucho lloraba, bien se le hincharon los ojos, se le hincharon los párpados. Pero llegó hasta él la Muerte y no hizo más que huir ante ella, se ausentó, entre cañas de maíz verde se fue a meter, tomó el aspecto, se convirtió en caña que en dos permanece, cuyo nombre (es) doble, “doble labrador”(nr. El 1o. ).	Ic cenca chocaya, huel ixpopozahuac ixcuatolpopozahuac. Auh in yeh itech onaci Miquiztli, zan teixpampa yehuac, cholo, toctitlan calactihuetz, ipan omixeuh ic mocueptihuetz in tochtli ome mani, maxaltic in quitocayotia millaca—xolotl.
Pero allí entre las cañas fue visto. Otra vez ante su cara huyó, y bien se fue a meter entre los magueyes, se convirtió también en maguey que dos permanece, cuyo nombre es “maguey doble”. También otra vez fue visto. Otra vez bien se fue a meter en el agua, se convirtió en ajolote (amblystoma): empero allí lo cogieron, con lo cual le dieron muerte.	Auh in uncan ittoc in toctitlan, ye noceppa teixpampa yehuac, ye no cuele metitlan calactihuetz, no ic onmocueptihuetz in metl ome mani in itoca mexolotl. Ye noceppa ittoc ye no cuele atlan calactihuetz axolotl mocuepato ye huel umpa canato inic conmictique.
Y dicen que aunque todos los dioses habían muerto, sin embargo no pudo moverse, no pudo seguir su marcha el dios para hacer su oficio. Ehécatl, se paró el viento, mucho empujó, hizo ímpetu con viento, (y) en seguida pudo moverse y luego ya por esto va siguiendo su marcha.	Auh quitoa in manel muchintin teteu onmicque, zannel amo huel ic olim, amo huel ic otlatocac in teutl tonatiuh ic itequiuh onmochiuh Hécatl, moquetz in Hécatl, cenca molhui, totocac in ehecac, quin yehuatl huel colini, niman ye ic otlatoca.
Y cuando ya él va siguiendo su marcha, allá se quedó la Luna; cuando salió su salida el sol también le fue siguiendo la luna: con lo cual allí se apartaron, hicieron diferente derrotero cada vez que van a salir: dura todo el día el sol, pero la luna de noche hace su oficio, cada noche pone su cargo, de noche trabaja.	Auh in ic icaiac ye otlatoca, zan umpa oninocauh in meztli; quinicuac in ocalaquito icalaquian Tonatiuh, ye no cuele ic hualehuac in meztli: ic umpa mopatilique, motlallotilique inic ce ceppa hualquiza; tlacemilhuiltia in Tonatiuh, auh in meztli yohual tequitl quitlaza, ce yohual quitlaza, yohualtequi.
De ahí aparece esto que se dice que aquel la luna Tecuciztecatl hubiera sido el sol si primero se hubiera echado al fuego, por la razón de que él primero se presentó (y) todo precioso con lo que hizo penitencia.	Ic oncan hin neci mitoa ca yehuatl Tonatiuh yezquia in meztli Tecuciztecatl intla ye achto onhuetzini tleco, ipampa ca yehuatl achto mixquetz inic muchi tlazotli ipan tlamaceuh.
Aquí acaba este mito, fábula que hace largo tiempo narraban los viejos que eran sus guardianes.	Nican tlami inin nenonotzalli zazanilli in ye huecauh ic tlatlanonotzaya huehuetque in impiel catca.
Se refería, se decía que así hubo ya antes cuatro vidas, y que ésta era la quinta edad.	Motenewa mihtoa, ka iw nawtlamantli mochiw nemilistli ipan iya makwili edad.
Como lo sabían los viejos, en el año 1 Conejo se cimentó la tierra y el cielo. Y así lo sabían, que cuando se cimentó la tierra y el cielo, habían existido ya cuatro clases de hombres, cuatro clases de vidas. Sabían igualmente que cada una de ellas había existido en un Sol [una edad]. Y decían que a los primeros hombres su dios los hizo, los forjó de ceniza. Esto lo atribuían a Quetzalcóatl, cuyo signo es 7 Viento, él los hizo, él los inventó.	In yuki matia wewetke inipan in se tochtli, ipan moman in tlali in ilwikatl, iwan iwkimatia inikwak omoman tlali in ilwikatl oyu nawtlamantli onoka in tlaka nawtlamantlinemilistli, omochiw iniwkimatia se sentetl in tonatiw katka, aw kitowaya kanextli in kinchichiw inkinyokox intew kitowaya itech kitlamiaya in Ketsalkoatl chikome ehekatl itonal in kinchiw in kinyokox.
El primer Sol [edad] que fue cimentado, su signo fue 4 Agua, se llamó Sol de Agua. En él sucedió que todo se lo llevó el agua. Las gentes se convirtieron en peces.	Inik se tonatiw on manka in itsiwkkan 4 Atl initonal mitoa atonatiw inipan in ye ikwak in mochiw in atoko ak in anenextiwak in tlakamichtiwak.
Se cimentó luego el segundo Sol [edad]. Su signo era 4 Tigre. En él sucedió que se oprimió el cielo, el Sol no seguía su camino. Al llegar el Sol al mediodía, luego se hacía de noche y cuando ya se oscurecía, los tigres se comían a las gentes. Y en este Sol vivían los gigantes. Decían los viejos que los gigantes así saludaban: “no se caiga usted”, porque quien se caía, se caía para siempre.	Inik ome tonatiw on manka 4 Oselotl in itonalkatka motenewa oselotonatiw, ipan mochiw tlapachiw in ilwikatl in tonatiw, inikwak amo otlatokaya kan nepantla tonatiw, mochiwa niman tlayowaya in onotlayowak niman Tekwaloya. Au ipan inin Kinametin nemia konitotiwi in wewetke in wetlapaloliskatka matimowetsiti ipampa in akin wetsin ik sen wetsin.
Se cimentó luego el tercer Sol. Su signo era 4 Lluvia. Se decía Sol de Lluvia [de fuego]. Sucedió que durante él llovió fuego, los que en él vivían se quemaron. Y durante él llovió también arena. Y decían que en él llovieron las piedrezuelas que vemos, que hirvió la piedra tezontle y que entonces se enrojecieron los peñascos.	Inik eyi tonatiw on manka 4 Kiawitl in itonal mitoa Kiyawtonatiw, ipan in in mochiw inipan tlekiaw in onoka ik tlatlake, iwan ipan xaltekiyaw konitowa ikwak motepew in Xaltetl intik itta iwan poposokak in tesontli, iwan iqwak momaman in texkali chichichiliwtikak.
Su signo era 4 Viento, se cimentó luego el cuarto Sol. Se decía Sol de Viento. Durante él todo fue llevado por el viento. Todos se volvieron monos. Por los montes se esparcieron, se fueron a vivir los hombres-monos.	Inik 4 tonatiw, 4 Ehekatl intonal ekatonatiw, ipan in ekatokoak osomatiwak kwautla kin tepewato in onoka tlakaosomatin.
El Quinto Sol: 4 Movimiento su signo. Se llama Sol de Movimiento, porque se mueve, sigue su camino. Y como andan diciendo los viejos, en él habrá movimientos de tierra, habrá hambre y así pereceremos.	Inik makwili tonatiw 4 Olin in itonal mitoa olintonatiw ipampa molini in otlatoka aw in yu konitotiwi in wewetke, ipan inin mochiwas tlalolinis mayanalos inik tipoliwiske.
En el año 13 Caña, se dice que vino a existir, nació el Sol que ahora existe. Entonces fue cuando iluminó, cuando amaneció, el Sol de Movimiento que ahora existe. 4 Movimiento es su signo. Es éste el quinto Sol que se cimentó, en él habrá movimiento de tierra, en él habrá hambres.	In ipan in 13 akatl kilmachyeipan in tlakat in axkan onmantiw tonatiw, ye ikwak tlawes ye ikwak tlatwik in axkan onmantiw olin tonatiw. 4 olin in itonal, ik 5 inin tonatiw on mani ipan tlalolinis mayanalos.
